les	die
est	ist
une	eine
une	ein
dans	in
catégorie	kategorie
par	von
par	durch
pour	für
sur	auf
qui	wer
que	dass
avec	mit
son	son
pas	nicht
sont	sind
elle	sie
été	sommer
comme	wie
mais	aber
cette	dieser
cette	dieses
cette	diese
pop	pop
deux	zwei
ses	seine
naissance	geburt
aussi	auch
france	frankreich
saint	heiliger
après	nach
fait	gemacht
fait	fakt
entre	zwischen
sous	unter
même	selbst
même	sogar
français	französisch
ont	haben
paris	paris
lui	ihm
lui	er
lieu	ort
autres	sonstige
décès	tod
références	referenzen
liens	links
était	war
commune	gemeinde
ville	stadt
jean	johannes
date	datum
dont	davon
peut	kann
depuis	seitdem
depuis	seit
première	erste
alors	dann
premier	erste
ces	diese
http	http
ainsi	so
film	film
voir	siehe
pays	land
source	quelle
grand	groß
tout	alles
groupe	gruppe
également	auch
titre	titel
monde	welt
nord	norden
années	jahre
bien	gut
contre	gegen
liste	liste
puis	dann
équipe	mannschaft
club	club
sud	süden
partie	teil
avant	vor
non	nein
très	sehr
trois	drei
articles	artikel
guerre	krieg
sans	ohne
saison	jahreszeit
fin	ende
vers	würmer
année	jahr
temps	zeit
plusieurs	mehrere
faire	machen
faire	tun
mars	märz
histoire	geschichte
série	reihe
série	serie
joueur	spieler
mai	mai
tour	tour
mort	tod
juin	juni
jpg	jpg
pierre	pierre
région	region
janvier	januar
septembre	september
juillet	juli
état	zustand
octobre	oktober
place	platz
famille	familie
états	zustände
général	allgemein
avril	april
insee	insee
tous	alle
politique	politik
album	album
décembre	dezember
août	august
todo	todo
novembre	november
avait	hatte
donc	also
prix	preise
prix	preis
align	align
nouvelle	neue
février	februar
département	abteilung
peu	wenig
américain	amerikaner
américain	amerikanisch
soit	entweder
début	anfang
ligne	zeile
suite	fortsetzung
championnat	meisterschaft
encore	wieder
selon	nach
image	bild
vie	leben
lien	link
football	fußball
pendant	während
jeux	spiele
moins	weniger
ouest	westen
page	seite
nouveau	neu
vous	sie
partir	weggehen
village	dorf
université	universität
louis	louis
nombre	anzahl
nombre	zahl
quelques	einige
siècle	jahrhundert
coupe	schnitt
population	bevölkerung
connexes	verwandte
communes	gemeinden
président	präsident
national	national
société	gesellschaft
quatre	vier
cas	fälle
cas	fall
jeu	spiel
genre	gattung
musique	musik
fils	sohn
roi	könig
parti	partei
jour	tag
forme	form
époque	epoche
new	new
ancien	alten
origine	herkunft
ordre	reihenfolge
château	schloss
château	burg
école	schule
carrière	karriere
part	anteil
deuxième	zweites
deuxième	zweiter
bar	bar
charles	charles
points	punkte
paul	paul
rue	straße
chef	leiter
père	vater
exemple	beispiel
durant	durant
rapport	bericht
canton	kanton
type	typ
habitants	einwohner
point	punkt
compte	konto
période	zeitraum
armée	armee
marie	marie
marie	maria
chez	bei
discuter	diskutieren
car	denn
projet	projekt
chaque	jedes
chaque	jede
anglais	englisch
province	provinz
john	john
international	international
conseil	beratung
françois	françois
maison	haus
cela	dies
fonction	funktion
toujours	immer
doit	muss
production	produktion
certains	einige
membre	mitglied
rôle	rolle
droit	recht
mois	monat
île	insel
jacques	jacques
score	score
ensuite	dann
langue	sprache
dit	sagt
gouvernement	regierung
center	center
petit	klein
argent	silber
style	stil
face	face
quand	wann
top	top
ministre	minister
ensemble	zusammen
théâtre	theater
épisode	folge
épisode	episode
scène	szene
situé	gelegen
asp	asp
musée	museum
troisième	dritter
auteur	autor
nous	wir
système	system
création	schaffung
création	kreation
stade	stadion
reste	bleibt
reste	bleib
seconde	sekunde
roman	roman
jours	tage
édition	bearbeiten
éditions	editionen
sera	wird
permet	ermöglicht
âge	alter
robert	robert
officiel	offizielle
environ	ungefähr
effet	effekt
version	version
membres	mitglieder
niveau	ebene
champion	champion
espèce	tierart
michel	michel
raison	grund
raison	vernunft
modèle	modell
travail	arbeit
femme	frau
cinq	fünf
déjà	schon
déjà	bereits
bas	niedrig
texte	text
terre	erde
allemagne	deutschland
from	from
compétition	wettkampf
wikipédia	wikipedia
allemand	deutsch
britannique	britisch
porte	tür
hommes	männer
italie	italien
bataille	schlacht
corps	körper
demi	halbe
siège	sitz
personnes	personen
nommé	benannt
route	straße
finale	finale
jeune	jung
match	match
peuvent	können
york	york
long	long
latitude	breitengrad
base	base
base	basis
études	studien
communauté	gemeinschaft
militaire	militär
section	abschnitt
bronze	bronze
livre	buch
haut	hoch
suisse	schweiz
canada	kanada
valign	valign
suivant	nächster
beaucoup	viel
dire	sagen
seul	allein
fille	mädchen
enfants	kinder
direction	richtung
position	position
ailleurs	woanders
ailleurs	anderswo
merci	danke
tête	kopf
territoire	territorium
union	union
prend	nimmt
maire	bürgermeister
présente	präsentiert
personnalité	persönlichkeit
ligue	liga
public	publikum
pages	seiten
agit	wirkt
externe	extern
externe	externe
simple	einfach
dernière	letzte
henri	henri
chanson	lied
poste	posten
culture	kultur
développement	entwicklung
sortie	ausgang
empire	empire
québec	québec
david	david
loi	gesetz
équipes	teams
mer	meer
vue	ansicht
espagne	spanien
mère	mutter
fichier	datei
acteur	schauspieler
parcours	strecke
recherche	suche
classement	einstufung
code	code
entraîneur	trainer
web	web
arrondissement	arrondissement
directeur	direktor
joseph	joseph
semble	scheint
ici	hier
réalisé	realisiert
réalisé	realisierte
existe	existiert
six	sechs
créé	erstellt
écrit	geschrieben
petite	kleine
bois	holz
retour	zurück
numéro	nummer
sainte	heiligen
comté	grafschaft
terme	begriff
connu	bekannt
formation	ausbildung
technique	technik
révolution	revolution
objet	gegenstand
mon	meine
mon	mein
philippe	philippe
question	frage
cinéma	kino
van	van
médaille	medaille
serait	wäre
œuvres	werke
écrivain	schriftsteller
italien	italienisch
championnats	meisterschaften
films	filme
parfois	manchmal
sources	quellen
parc	park
moyenne	durchschnitt
mouvement	bewegung
succès	erfolg
rivière	fluss
rivière	rivière
jamais	niemals
vidéo	video
martin	martin
député	abgeordneter
claude	claude
superficie	fläche
till	till
san	san
notre	unser
notre	unsere
bon	gut
peintre	maler
voix	stimme
rouge	rot
district	distrikt
seulement	nur
pont	brücke
libre	frei
air	air
milieu	mitte
festival	festival
belgique	belgien
georges	georges
blanc	weiß
travaux	arbeiten
donne	gibt
produit	produkt
diffusion	verbreitung
aide	hilfe
action	aktion
andré	andré
réseau	netzwerk
utilisé	verwendet
victoire	sieg
femmes	frauen
minutes	minuten
aurait	hätte
autour	herum
left	left
durée	laufzeit
durée	dauer
espèces	arten
angleterre	england
afrique	afrika
monuments	denkmäler
sens	sinn
personne	person
mis	mis
frère	bruder
rencontre	begegnung
trop	zu
japon	japan
publié	veröffentlicht
domaine	bereich
particulier	privatperson
quartier	viertel
quartier	stadtviertel
color	color
honneur	ehre
seule	allein
cause	ursache
rien	nichts
nouvelles	news
nouvelles	nachrichten
iii	iii
comte	graf
fort	fort
hockey	hockey
moi	ich
rome	rom
possible	möglich
dix	zehn
taille	größe
sport	sport
croix	kreuz
élections	wahlen
enfin	endlich
millions	millionen
noir	schwarz
joue	spielt
londres	london
agglomération	ballungsraum
chapelle	kapelle
russe	russisch
prince	prinz
malgré	trotz
activités	aktivitäten
réalisateur	regisseur
radio	radio
classe	klasse
lieux	standorte
espace	raum
villes	städte
fer	eisen
activité	aktivität
commence	beginnt
organisation	organisation
sélection	auswahl
assez	genug
participe	beteiligt
institut	institut
james	james
internationale	internationale
cadre	rahmen
sept	sieben
lac	see
télévision	fernsehen
duc	herzog
personnage	charakter
précédent	vorhergehenden
précédent	vorherige
évêque	bischof
cour	hof
richard	richard
adresse	anschrift
adresse	adresse
php	php
william	william
thomas	thomas
ball	ball
résultats	ergebnisse
problème	problem
bonne	gute
nature	natur
michael	michael
vol	flug
port	hafen
right	right
donné	gegeben
discussion	diskussion
dame	dame
épouse	ehefrau
axe	achse
mesure	messung
prendre	nehmen
important	wichtig
données	daten
george	george
pologne	polen
couleur	farbe
collection	sammlung
actrice	schauspielerin
élu	gewählt
régiment	regiment
dessus	oberseite
loire	loire
bande	band
capitale	hauptstadt
côte	küste
étape	schritt
plutôt	eher
combat	kampf
footballeur	fußballer
forces	kräfte
royal	royal
aucune	keine
russie	russland
nicolas	nicolas
possède	besitzt
presse	presse
académie	akademie
construit	erbaut
tournoi	turnier
épisodes	episoden
passage	durchgang
entrée	eingang
revue	zeitschrift
jeunes	jugendliche
ceinture	gürtel
tableau	tabelle
heures	stunden
maître	meister
services	dienstleistungen
appelé	aufgerufen
olympique	olympischen
subdivision	unterteilung
bernard	bernard
qualité	qualität
langues	sprachen
propre	sauber
chine	china
lettres	buchstaben
patrimoine	erbe
com	com
tours	tours
tours	touren
obtient	bekommt
obtient	erhält
compositeur	komponist
joueurs	spieler
lyon	lyon
mal	schlecht
rock	rock
abbaye	abtei
nuit	nacht
principalement	überwiegend
bretagne	bretagne
avaient	hatten
clubs	vereine
met	met
vitesse	geschwindigkeit
scénario	drehbuch
réalisation	realisierung
statut	status
groupes	gruppen
avis	meinungen
salle	saal
carte	landkarte
valeur	wert
utilisation	verwendung
utilisation	gebrauch
palais	palast
émission	emission
situation	lage
droits	rechte
court	kurz
vallée	tal
comité	ausschuss
anciens	ältere
anciens	alten
rugby	rugby
cité	zitiert
basse	bass
pro	pro
total	insgesamt
nationalité	nationalität
nationalité	staatsangehörigkeit
savoir	wissen
glace	eis
proche	nah
mot	wort
main	hand
huit	acht
voïvodie	woiwodschaft
assemblée	versammlung
populaire	beliebt
del	del
publication	veröffentlichung
dieu	gott
uni	uni
japonais	japanisch
australie	australien
catholique	katholisch
mission	mission
https	https
accord	vereinbarung
campagne	kampagne
traduction	übersetzung
anne	anne
départ	abreise
montréal	montreal
programme	programm
bgcolor	bgcolor
choix	wahl
enfant	kind
mieux	besser
maurice	maurice
défense	verteidigung
vice	vize
contrôle	kontrolle
noms	namen
produits	produkte
internet	internet
label	label
hiver	winter
fondation	stiftung
troupes	truppen
antoine	antoine
daniel	daniel
cœur	herz
îles	inseln
marine	marine
bâtiment	gebäude
peter	peter
juste	gerade
fondé	gegründet
amour	liebe
mont	mount
statistiques	statistiken
statistiques	statistik
science	wissenschaft
personnages	charaktere
bonjour	hallo
marc	marc
économique	wirtschaftlichen
unité	einheit
particulièrement	besonders
lignes	linien
lignes	zeilen
traité	vertrag
montre	uhr
idée	idee
éditeur	herausgeber
littérature	literatur
attaque	angriff
records	records
sol	boden
chaîne	zeichenkette
fondée	gegründet
pourrait	könnte
reçoit	empfängt
reçoit	erhält
format	format
mode	modus
original	original
espagnol	spanisch
producteur	produzent
artiste	künstler
créer	erstellen
composition	zusammensetzung
décide	entscheidet
décide	entscheide
garde	wache
votre	ihre
votre	ihr
sécurité	sicherheit
fédération	föderation
quatrième	vierter
junior	junior
police	polizei
comédie	komödie
albert	albert
bruxelles	brüssel
empereur	kaiser
xxe	xxe
infanterie	infanterie
ministère	ministerium
rejoint	beigetreten
chevalier	ritter
armes	waffen
livres	bücher
personnalités	persönlichkeiten
unique	einzigartig
capitaine	kapitän
large	breit
guillaume	guillaume
commission	kommission
demandé	fragte
divers	verschiedenes
décision	entscheidung
classique	klassisch
présent	gegenwart
fit	fit
passé	vergangenheit
mandat	mandat
berlin	berlin
isbn	isbn
taux	steuersätze
surface	oberfläche
architecture	architektur
transport	transport
rené	rené
oui	ja
pièce	stück
pièce	münze
pratique	praxis
conseiller	berater
portail	portal
terrain	grundstück
comprend	umfasst
comprend	beinhaltet
secrétaire	sekretärin
secrétaire	sekretär
world	world
donner	geben
chose	sache
fonctions	funktionen
accès	zugang
marché	markt
charge	last
alpes	alpen
sites	standorte
utiliser	verwenden
économie	wirtschaft
longueur	länge
légende	legende
pense	denke
vingt	zwanzig
arrivée	ankunft
protection	schutz
scénariste	drehbuchautor
bibliothèque	bibliothek
commerce	handel
influence	einfluss
énergie	energie
devenu	geworden
fiction	fiktion
intérêt	interesse
structure	struktur
laurent	laurent
kilomètres	kilometer
jeunesse	jugend
régions	regionen
majorité	mehrheit
passer	verbringen
exposition	ausstellung
poids	gewicht
santé	gesundheit
feu	feuer
atteint	erreicht
profession	beruf
trouver	finden
voyage	reisen
logo	logo
gestion	verwaltung
localité	ortschaft
arrière	hinten
régime	diät
black	black
henry	henry
autriche	österreich
résultat	ergebnis
couleurs	farben
comment	wie
nations	nationen
central	zentrale
apparaît	erscheint
orchestre	orchester
concours	wettbewerbe
concours	wettbewerb
moderne	modern
phase	phase
problèmes	probleme
journaliste	journalist
record	rekord
célèbre	berühmt
doivent	müssen
mariage	hochzeit
devenir	werden
svg	svg
powiat	powiat
architecte	architekt
message	nachricht
nos	unsere
roger	roger
presque	fast
esprit	geist
moteur	motor
ouverture	eröffnung
alain	alain
séries	reihen
vienne	wien
galerie	galerie
découvert	entdeckt
parlement	parlament
zip	zip
étudiant	kursteilnehmer
techniques	techniken
théorie	theorie
mémoire	speicher
ami	freund
super	super
images	bilder
éducation	bildung
magazine	magazin
don	don
pourquoi	warum
aller	gehen
officier	offizier
hauteur	höhe
camp	camp
secteur	sektor
secteur	bereich
probablement	vermutlich
probablement	wahrscheinlich
saisons	jahreszeiten
temple	tempel
temple	temple
forêt	wald
maintenant	jetzt
forte	forte
conflit	konflikt
commandant	kommandant
meurt	stirbt
ben	ben
docteur	doktor
christian	christian
gouverneur	gouverneur
collège	kollegium
bassin	becken
bureau	schreibtisch
contrat	vertrag
romain	römischen
professionnel	professionelle
marseille	marseille
arbitre	schiedsrichter
justice	gerechtigkeit
justice	justiz
directement	direkt
appel	anruf
semaine	woche
pied	fuß
you	you
chanteur	sänger
neuf	neun
photographie	fotografie
principe	grundsatz
principe	prinzip
latin	latein
victor	victor
connue	bekannt
bord	bord
distribution	vertrieb
environnement	umwelt
canadien	kanadier
entreprises	unternehmen
lumière	licht
frères	brüder
train	zug
lieutenant	leutnant
textes	texte
royale	königliche
moitié	hälfte
josé	josé
studio	studio
réponse	antwort
reine	königin
patrick	patrick
physique	physik
auteurs	autoren
chansons	lieder
compris	verstanden
compris	inklusive
étienne	étienne
représente	repräsentiert
via	via
californie	kalifornien
militaires	militär
pape	papst
quoi	was
questions	fragen
parle	spricht
lire	lesen
industrie	industrie
lettre	brief
denis	denis
brésil	brasilien
man	man
opération	operation
piste	spur
paix	frieden
vieux	alt
propriétaire	eigentümer
faible	schwach
pyrénées	pyrenäen
algérie	algerien
chargé	geladen
cathédrale	kathedrale
participation	teilnahme
participation	beteiligung
puissance	macht
puissance	leistung
zones	zonen
simon	simon
endémique	endemisch
formule	formel
néanmoins	dennoch
néanmoins	nichtsdestoweniger
quitte	verlässt
opéra	oper
joué	gespielt
piano	klavier
montagne	berg
découverte	entdeckung
red	red
front	front
front	stirn
poète	dichter
marcel	marcel
champ	feld
val	val
religieux	religiös
archives	archiv
vote	abstimmung
projets	projekte
formes	formen
proximité	nähe
seront	werden
obtenir	erhalten
angeles	angeles
belle	schöne
motif	motiv
chant	gesang
colonel	oberst
congrès	kongress
chinois	chinesisch
frédéric	frédéric
soleil	sonne
allemands	deutsche
moscou	moskau
sportif	sportlich
amis	freunde
toulouse	toulouse
peinture	malerei
légion	legion
inclinaison	neigung
mexique	mexiko
cinquième	fünfter
guitare	gitarre
liberté	freiheit
html	html
contenu	inhalt
star	star
fête	fest
rhône	rhône
photo	foto
canal	kanal
vincent	vincent
jouer	spielen
jules	jules
précédente	vorherige
polonais	polnisch
analyse	analyse
offre	angebot
travaille	arbeitet
travaille	arbeite
frontière	grenze
max	max
américains	amerikaner
existence	existenz
indépendance	unabhängigkeit
love	love
uniquement	nur
résistance	widerstand
smith	smith
caractère	charakter
contient	enthält
bleu	blau
asie	asien
jack	jack
excentricité	exzentrizität
www	www
guy	guy
signifie	bedeutet
objets	objekte
border	border
faits	fakten
licence	lizenz
juifs	juden
médecin	arzt
écrire	schreiben
lance	lance
fonds	fonds
ehess	ehess
besoin	brauchen
fondateur	gründer
grec	griechisch
bordeaux	bordeaux
règles	regeln
soldats	soldaten
mark	mark
chicago	chicago
provence	provence
religion	religion
successeur	nachfolger
cimetière	friedhof
somme	summe
formé	ausgebildet
éviter	vermeiden
réserve	reserve
défaite	niederlage
ceci	dies
maritime	maritime
cardinal	kardinal
sert	dient
encyclopédie	enzyklopädie
résumé	zusammenfassung
lorraine	lothringen
parents	eltern
tournée	tournee
rose	rose
recensement	volkszählung
philosophie	philosophie
open	open
hôpital	krankenhaus
propriété	eigentum
cycliste	radfahrer
ouvert	geöffnet
parler	sprechen
expression	ausdruck
astéroïdes	asteroiden
nécessaire	notwendig
règne	regiert
suède	schweden
difficile	schwierig
inconnu	unbekannt
tom	tom
champions	champions
modèles	vorlagen
vit	lebt
meilleurs	besten
animaux	tiere
cheval	pferd
débuts	anfänge
débuts	debüt
milan	mailand
rive	ufer
animation	animation
raymond	raymond
méthode	methode
communication	kommunikation
jardin	garten
min	min
avion	flugzeug
internes	internen
internes	interne
mots	wörter
portugal	portugal
vert	grün
strasbourg	straßburg
personnel	personal
local	lokale
local	lokal
frank	frank
olivier	olivier
catherine	katharina
historien	historiker
inde	indien
relation	beziehung
baptiste	baptiste
étudiants	studenten
maisons	häuser
manque	fehlt
comptait	zählte
plein	voll
naturel	natürlichen
naturel	natürliche
opposition	opposition
franco	franco
adaptation	anpassung
music	music
abbé	abt
gérard	gérard
argument	argument
semaines	wochen
familles	familien
expérience	erfahrung
gardien	hüter
gardien	wächter
appelle	ruft
dramatique	dramatisch
extérieur	außen
restauration	wiederherstellung
draft	draft
médecine	medizin
municipal	municipal
marne	marne
régional	regionaler
thème	thema
prison	gefängnis
distance	entfernung
capacité	kapazität
littéraire	literarische
écoles	schulen
arrêté	verhaftet
arrêté	gestoppt
tradition	tradition
réalité	realität
savoie	savoie
étoile	stern
jaune	gelb
serbie	serbien
office	office
traitement	behandlung
masse	masse
arc	bogen
arc	arc
tombe	fällt
risque	risiko
vrai	wahr
armées	armeen
arabe	arabisch
acte	urkunde
arthur	arthur
live	live
grèce	griechenland
major	major
santa	santa
essai	prüfung
décrit	beschreibt
décrit	beschrieben
écosse	schottland
albums	alben
héros	helden
termes	begriffe
permis	führerschein
nantes	nantes
midi	mittag
midi	midi
aura	aura
pdf	pdf
géographique	geografischen
ciel	himmel
anti	anti
rang	rang
washington	washington
rurale	ländlich
maladie	krankheit
aéroport	flughafen
king	king
dictionnaire	wörterbuch
autorité	autorität
with	with
préfecture	präfektur
officielle	offizielle
futur	zukunft
objectif	ziel
ingénieur	ingenieur
irlande	irland
hongrie	ungarn
absence	abwesenheit
guerres	kriege
yves	yves
chanteuse	sängerin
crise	krise
brigade	brigade
chapitre	kapitel
laisse	lass
madrid	madrid
drapeau	flagge
application	anwendung
responsable	verantwortlich
circuit	schaltung
banque	bank
décédé	verstorben
danse	tanzen
genève	genf
développé	entwickelt
systèmes	systeme
élèves	schüler
officiellement	offiziell
remplacé	ersetzt
univers	universum
villages	dörfer
vraiment	wirklich
american	american
argentine	argentinien
salon	wohnzimmer
libération	befreiung
libération	freilassung
entièrement	vollständig
places	plätze
jazz	jazz
caractéristiques	merkmale
réunion	sitzung
trente	dreißig
julien	julien
chasse	jagd
paru	erschienen
processus	prozesse
comporte	kennzeichnet
gaz	gas
orléans	orléans
catégories	kategorien
press	press
united	united
mixte	gemischt
régulièrement	regelmäßig
gmina	landgemeinde
juan	juan
lee	lee
rapide	schnell
agriculture	landwirtschaft
traduit	übersetzt
chœur	chor
décret	dekret
léon	léon
naturelle	natürliche
plantes	pflanzen
permettre	ermöglichen
nommée	benannt
résidence	residenz
fusion	fusion
critères	kriterien
commandement	kommando
portrait	porträt
mairie	rathaus
jan	jan
sang	blut
jeanne	jeanne
yeux	augen
désigne	benennt
désigne	bezeichnet
types	typen
prédécesseur	vorgänger
retraite	ruhestand
description	beschreibung
table	tisch
antonio	antonio
blue	blue
emploi	beschäftigung
alliance	allianz
unités	einheiten
quel	welches
quel	welche
brun	braun
participé	teilgenommen
actions	aktionen
actions	aktien
baron	baron
contributeurs	mitwirkende
biographie	biografie
effets	effekte
bosnie	bosnien
explique	erkläre
explique	erklärt
égypte	ägypten
avenue	avenue
blocage	blockierung
dominique	dominique
nœud	knoten
serbe	serbisch
événements	veranstaltungen
christophe	christophe
atelier	werkstatt
auguste	auguste
raisons	gründe
devrait	sollte
francis	francis
atlantique	atlantik
cent	hundert
voiture	auto
agent	agent
disney	disney
chute	sturz
connaît	kennt
présentation	präsentation
documentaire	dokumentarfilm
cartes	karten
sièges	sitze
secret	geheimnis
couple	paar
col	kragen
col	col
mary	mary
conférence	konferenz
alsace	elsass
mains	hände
alfred	alfred
locaux	lokalen
locaux	räumlichkeiten
coureur	läufer
basé	gegründet
différence	unterschied
xls	xls
changement	änderung
députés	abgeordnete
commencé	begonnen
électrique	elektrisch
opérations	operationen
diocèse	bistum
rhin	rhein
identité	identität
normandie	normandie
variation	veränderung
romans	romane
sportive	sportliche
bourg	bourg
hommage	tribut
transports	verkehr
rio	rio
juge	richter
francisco	francisco
néerlandais	niederländisch
lille	lille
complexe	komplex
concept	konzept
universitaire	akademischen
titulaire	inhaber
contexte	kontext
vis	schrauben
concert	konzert
lois	gesetze
douze	zwölf
ferme	bauernhof
one	one
édouard	édouard
massif	massiv
vente	verkauf
athlétisme	leichtathletik
culte	kult
répartition	umlageverfahren
matériel	material
avocat	rechtsanwalt
bras	arm
calais	calais
proposition	vorschlag
conduit	führt
perdu	verloren
nice	nizza
visite	besuch
solution	lösung
volley	volley
promu	gefördert
promu	befördert
portes	türen
informatique	informatik
conception	konzeption
mur	mauer
scientifiques	wissenschaftler
tourisme	tourismus
green	green
luc	luc
façade	fassade
statue	statue
photos	fotos
construire	bauen
tente	zelt
scott	scott
liège	lüttich
huile	öl
convention	übereinkommen
convention	konvention
orient	orient
tourné	gedreht
dessin	zeichnung
manuel	handbuch
joe	joe
pression	druck
maroc	marokko
faux	falsch
christ	christus
colombie	kolumbien
documents	dokumente
bourgogne	burgund
destination	zielort
champs	felder
vierge	jungfrau
température	temperatur
enfance	kindheit
acteurs	akteure
candidat	kandidaten
candidat	kandidat
cercle	kreis
essais	prüfungen
mention	erwähnung
agence	agentur
perd	verliert
mari	ehemann
élément	element
pouvait	konnte
représentation	vertretung
cycle	zyklus
chemins	pfade
renaissance	renaissance
renaissance	wiedergeburt
attention	achtung
jones	jones
marin	marin
domaines	domains
usine	fabrik
fontaine	fontaine
parlementaire	parlamentarische
parlementaire	parlamentarischen
roland	roland
printemps	frühling
prêtre	priester
étoiles	sterne
réforme	reform
chris	chris
gabriel	gabriel
xixe	xixe
organisé	organisiert
organisé	organisierte
dos	rückseite
noël	weihnachten
enquête	erhebung
trouvé	gefunden
anomalie	anomalie
ign	ign
beau	schön
villa	villa
lecture	lesung
lecture	wiedergabe
montage	montage
professionnelle	berufliche
cantons	kantone
branche	zweig
batterie	akku
pointe	spitze
thèse	these
rgb	rgb
démocratique	demokratische
géographie	geographie
nancy	nancy
caroline	caroline
participer	teilnehmen
clair	klar
test	test
west	west
relativement	relativ
versions	versionen
venir	kommen
laisser	lassen
gilles	gilles
bataillon	bataillon
vin	wein
spécialiste	spezialist
vivant	lebend
ressources	ressourcen
ajouter	hinzufügen
rencontres	begegnungen
israël	israel
tué	getötet
siècles	jahrhunderte
présenté	präsentiert
territoires	territorien
png	png
mike	mike
napoléon	napoleon
net	net
planète	planet
bilan	bilanz
intervention	intervention
auparavant	zuvor
législature	wahlperiode
bob	bob
white	white
océan	ozean
idées	ideen
combats	kämpfe
tokyo	tokio
bus	bus
comprendre	verstehen
edward	edward
arme	waffe
dynastie	dynastie
erreur	fehler
publications	publikationen
coll	coll
organisme	organismus
williams	williams
faculté	fakultät
génération	generation
expédition	versand
tchèque	tschechisch
google	google
européens	europäer
arbre	baum
tribunal	gericht
règle	regel
walter	walter
possibilité	möglichkeit
eugène	eugène
avions	flugzeuge
archevêque	erzbischof
participants	teilnehmer
dvd	dvd
artillerie	artillerie
mesures	maßnahmen
occupation	belegung
occupation	besetzung
vent	wind
définition	definition
danemark	dänemark
administrateur	administrator
administrateur	verwalter
vos	ihre
bruno	bruno
travailler	arbeiten
églises	kirchen
mouvements	bewegungen
former	ausbilden
princesse	prinzessin
volonté	wille
volonté	willenskraft
germain	germain
oiseaux	vögel
homonymie	begriffsklärung
race	rasse
sûr	sicher
disponible	verfügbar
ski	skifahren
ouvre	öffnet
échelle	maßstab
machine	maschine
change	ändert
luxembourg	luxemburg
monte	monte
dimanche	sonntag
électronique	elektronischen
fil	draht
suivre	folgen
sixième	sechste
sixième	sechster
accident	unfall
cérémonie	zeremonie
discours	rede
bill	bill
finaliste	finalist
échange	austausch
riche	reich
complète	vollständige
néo	neo
effectif	tatsächlichen
feuilles	blätter
maréchal	marschall
herzégovine	herzegowina
spectacle	show
plans	pläne
moulin	mühle
déclare	deklariert
débat	debatte
numérique	digitalen
mayotte	mayotte
rendu	rendering
musicien	musiker
champagne	champagner
disparu	verschwunden
poésie	poesie
choisi	auserwählt
valeurs	werte
accueil	startseite
tar	tar
productions	produktionen
fédéral	bundes
big	big
montagnes	berge
louise	louise
supprimer	löschen
aventure	abenteuer
harry	harry
claire	claire
dirigé	geleitet
carlos	carlos
guide	führer
solid	solid
anna	anna
jésus	jesus
adjoint	stellvertretender
steve	steve
actif	aktiv
événement	veranstaltung
fonctionnement	funktionsweise
rennes	rennes
extrême	extrem
populations	populationen
venise	venedig
civil	zivilen
tunisie	tunesien
group	group
élus	gewählte
élus	gewählt
tiers	dritter
commande	bestellung
porté	getragen
quelle	welche
tony	tony
standard	standard
médias	medien
introduction	einleitung
porter	porter
approche	ansatz
reconnaissance	anerkennung
metal	metal
boston	boston
eric	eric
provinces	provinzen
pose	pose
orange	orange
adam	adam
fleurs	blumen
missions	dienstreisen
flotte	flotte
dessins	zeichnungen
monsieur	herr
côtes	küsten
amateurs	amateure
turquie	türkei
localisation	lokalisierung
gagne	gewinnt
officiers	offiziere
origines	herkunft
indépendant	unabhängige
nef	nef
émile	émile
house	house
marquis	marquis
pouvoirs	befugnisse
commercial	kommerziellen
bat	bat
césar	caesar
suédois	schwedisch
young	young
mille	tausend
direct	direkt
dames	damen
siren	siren
couronne	krone
attaquant	angreifer
attaquant	stürmer
mini	mini
privé	privat
appareil	gerät
commons	commons
diffusé	ausgestrahlt
outils	werkzeuge
complet	komplett
florence	florenz
trophée	trophäe
finlande	finnland
sinon	sonst
envoyé	gesendet
tôt	früh
comportement	verhalten
humain	menschlich
info	info
signé	unterzeichnet
texas	texas
russes	russen
septième	siebter
septième	siebte
septième	siebten
pascal	pascal
maillot	trikot
dispute	streit
lune	mond
orbite	umlaufbahn
championne	meisterin
scènes	szenen
society	society
amiral	admiral
murs	mauern
modifications	änderungen
norvège	norwegen
life	life
corse	korsika
mario	mario
initiative	initiative
marguerite	marguerite
mathématiques	mathematik
brown	brown
améliorer	verbessern
sénateur	senator
solo	solo
montpellier	montpellier
serge	serge
rouen	rouen
profondeur	tiefe
changer	ändern
croissance	wachstum
interne	internen
interne	interne
portugais	portugiesisch
stations	stationen
profil	profil
hans	hans
maximum	maximum
cabinet	kabinett
toi	dich
toi	dir
thierry	thierry
saône	saône
présidence	vorsitz
voyageurs	reisende
sculpteur	bildhauer
alexander	alexander
vision	vision
miss	miss
metz	metz
forêts	wälder
étapes	schritte
céleste	himmlischen
grade	besoldungsgruppe
impériale	kaiserlichen
sam	sam
dehors	draussen
servir	servieren
protéger	schützen
pacifique	pazifik
sébastien	sebastian
défenseur	verteidiger
diplôme	diplom
récit	erzählung
réaction	reaktion
cyclisme	radfahren
fabrication	herstellung
nucléaire	nukleare
karl	karl
chevaux	pferde
partis	parteien
représentants	vertreter
automne	herbst
caractères	zeichen
secondaire	sekundären
trains	züge
puisse	möge
grenoble	grenoble
roumanie	rumänien
prénom	vorname
victime	opfer
semi	semi
reconnu	erkannt
véhicules	fahrzeuge
garonne	garonne
interprétation	dolmetschen
interprétation	auslegung
papier	papier
gray	gray
emmanuel	emmanuel
plante	pflanze
boulevard	boulevard
interdit	verboten
entier	ganzzahl
angle	winkel
contemporain	zeitgenössische
preuve	beweis
barrage	staudamm
immédiatement	sofort
anvers	antwerpen
giovanni	giovanni
courses	rennen
sable	sand
toronto	toronto
routes	straßen
programmes	programme
placé	platziert
flore	flora
budget	haushalt
noblesse	adel
policier	polizist
toile	leinwand
inspiré	inspiriert
évaluation	bewertung
classification	klassifizierung
classification	klassifikation
détruit	zerstört
principes	grundsätze
principes	prinzipien
disparition	verschwinden
bistro	bistro
échec	gescheitert
échec	scheitern
rédaction	redaktion
serveur	server
oise	oise
signature	unterschrift
trône	thron
carl	carl
produire	produzieren
chien	hund
urss	udssr
time	time
nationaux	inländer
nationaux	nationalen
marqué	markiert
secondes	sekunden
requête	abfrage
studios	studios
largeur	breite
remplacer	ersetzen
org	org
françoise	françoise
spécial	spezial
professionnels	professionelle
récemment	kürzlich
munich	münchen
institutions	institutionen
vii	vii
pêche	angeln
complètement	vollständig
complètement	komplett
nation	nation
symbole	symbol
alger	algier
catalogue	katalog
prisonniers	gefangene
francophone	französischsprachigen
tir	schuss
emplacement	aufstellungsort
philosophe	philosoph
facilement	leicht
benoît	benedikt
décidé	entschieden
end	end
étage	stockwerk
coups	schläge
johnson	johnson
hongrois	ungarisch
rois	könige
pieds	füße
phénomène	phänomen
bel	bel
planètes	planeten
relais	relais
déposé	hinterlegt
roy	roy
exemples	beispiele
nomme	ernennt
marins	seeleute
poèmes	gedichte
tendance	trend
tendance	tendenz
libéral	liberal
orientation	orientierung
post	post
xxx	xxx
congo	kongo
street	street
ennemi	feind
moselle	mosel
indien	indischen
comptes	konten
joueuse	spielerin
calendrier	kalender
clocher	glockenturm
mécanique	mechanik
jérusalem	jerusalem
étrangers	ausländer
cavalerie	kavallerie
écran	bildschirm
concerts	konzerte
jim	jim
industriel	industriellen
rester	bleiben
consommation	verbrauch
mauvais	schlecht
brian	brian
condition	bedingung
utilisateurs	benutzer
plaine	ebene
perte	verlust
aires	aires
méthodes	methoden
impact	auswirkung
candidats	kandidaten
victoria	victoria
classes	klassen
attaques	angriffe
portée	reichweite
quitter	beenden
quitter	verlassen
oscar	oscar
définitivement	endgültig
romains	römer
collectif	kollektiv
quantité	menge
versailles	versailles
anniversaire	geburtstag
conservateur	konservierungsmittel
niveaux	ebenen
alex	alex
noter	bewerten
capable	fähig
estime	schätzt
couverture	deckung
arbres	bäume
émissions	emissionen
disposition	anordnung
racing	racing
conservatoire	konservatorium
parallèle	parallel
sénat	senat
ray	ray
milliards	milliarden
huitième	achte
pos	pos
bertrand	bertrand
blues	blues
modernes	modernen
réseaux	netzwerke
édité	herausgegeben
prit	nahm
duché	herzogtum
alliés	verbündete
tentative	versuch
mène	führt
canons	kanonen
vandalisme	vandalismus
difficultés	schwierigkeiten
penser	denken
tableaux	tabellen
personnelle	persönliche
autrefois	früher
café	kaffee
cher	teuer
inscription	anmeldung
luis	luis
isabelle	isabelle
confiance	vertrauen
propriétés	eigenschaften
aix	aix
instruments	instrumente
conserve	behält
départements	abteilungen
départements	departements
abrite	beherbergt
finances	finanzen
onze	elf
moteurs	motoren
allant	gehend
pratiques	praktiken
procédure	verfahren
charente	charente
dimensions	abmessungen
pertes	verluste
laval	laval
ontario	ontario
document	dokument
limites	grenzen
qualification	qualifikation
éric	éric
condamné	verurteilt
ernest	ernest
oncle	onkel
génie	genie
voitures	autos
jackson	jackson
best	best
démocrate	demokrat
drame	drama
entretien	wartung
vide	leer
musiciens	musiker
accepte	akzeptiere
handball	handball
benjamin	benjamin
reims	reims
windows	windows
canon	canon
collections	sammlungen
anthony	anthony
organisée	organisiert
organisée	organisierte
ali	ali
sculpture	skulptur
attendre	warten
destruction	zerstörung
destruction	vernichtung
samuel	samuel
cross	cross
real	real
avignon	avignon
amsterdam	amsterdam
sophie	sophie
auvergne	auvergne
enregistrement	registrierung
davis	davis
leader	leader
spécifique	spezifisch
peau	haut
ferdinand	ferdinand
duo	duo
espaces	leerzeichen
impossible	unmöglich
ukraine	ukraine
maine	maine
vieille	alte
acide	säure
gilbert	gilbert
succession	nachfolge
kevin	kevin
technologie	technologie
kim	kim
madeleine	madeleine
utile	nützlich
saut	springen
enceinte	schwanger
hugo	hugo
sacré	heilig
régulière	regelmäßige
sortir	ausgehen
centres	zentren
affluent	nebenfluss
stephen	stephen
clairement	eindeutig
athènes	athen
urbain	städtischen
xiii	xiii
clermont	clermont
préfet	präfekt
essentiel	wesentlichen
stéphane	stéphane
laboratoire	labor
distingue	unterscheidet
primaire	primären
wiki	wiki
équipage	besatzung
tuer	töten
logique	logik
night	night
adapté	angepasst
xavier	xavier
orgue	orgel
dépend	hängt
quasi	quasi
visible	sichtbar
habitat	lebensraum
breton	breton
souris	maus
photographe	fotograf
autoroute	autobahn
ponts	brücken
taylor	taylor
vérité	wahrheit
quinze	quinze
quinze	fünfzehn
mérite	verdient
jérôme	jérôme
assistant	assistent
bavière	bayern
marié	verheiratet
samedi	samstag
alan	alan
chili	chile
exécution	ausführung
carlo	carlo
boîte	box
rôles	rollen
gallimard	gallimard
alice	alice
las	las
saxe	sachsen
intermédiaire	mittelstufe
remarque	anmerkung
thèmes	themen
installation	installation
rapports	berichte
australien	australier
tournage	dreharbeiten
relief	relief
pierres	steine
north	north
histoires	geschichten
équivalent	gleichwertig
phrase	satz
récompense	belohnung
conçu	entworfen
structures	strukturen
chrétiens	christen
syndicat	gewerkschaft
lewis	lewis
menace	bedrohung
crois	glaub
basque	baskischen
mans	mans
lot	partie
débit	durchsatz
commissaire	kommissarin
araignées	spinnen
employé	angestellter
installé	installiert
arabes	araber
conserver	aufbewahren
manga	manga
conseils	tipps
andrew	andrew
diamètre	durchmesser
peintures	gemälde
invasion	invasion
adversaire	gegner
seraient	würden
franchise	franchise
iran	iran
blessés	verletzte
conscience	bewusstsein
représenté	vertreten
expositions	ausstellungen
rappelle	erinnert
naples	neapel
lion	löwe
peur	angst
prague	prag
lausanne	lausanne
peuples	völker
nomination	ernennung
little	little
respect	respekt
mobile	beweglich
mobile	mobil
chiffres	zahlen
british	british
raconte	erzähl
sœurs	schwestern
bientôt	bald
vendredi	freitag
commentaire	kommentar
véhicule	fahrzeug
della	della
irlandais	irisch
densité	dichte
catholiques	katholiken
rare	selten
transfert	übertragung
transfert	überweisung
laissé	gelassen
blessé	verletzt
annoncé	angekündigt
carré	quadrat
dimension	dimension
juive	jüdische
var	var
lit	bett
floride	florida
servi	serviert
seuil	schwellenwert
loup	wolf
détroit	meerenge
préparation	zubereitung
minimum	minimum
révolutionnaire	revolutionär
bibliographie	bibliographie
million	million
poème	gedicht
extrait	auszug
hill	hill
rivières	flüsse
renommé	umbenannt
gris	grau
aquitaine	aquitanien
clément	clément
barbara	barbara
notoriété	bekanntheit
euro	euro
danger	gefahr
wilson	wilson
similaire	ähnlich
travaillé	gearbeitet
cordes	seile
golden	golden
détail	detail
dan	dan
accompagné	begleitet
hypothèse	hypothese
matériaux	materialien
risques	risiken
charlotte	charlotte
jury	jury
anglo	anglo
révolte	revolte
révolte	aufstand
enseigne	lehrt
franc	franc
révèle	offenbart
didier	didier
mac	mac
variété	vielzahl
ascension	aufstieg
vendu	verkauft
game	game
ford	ford
jane	jane
observatoire	beobachtungsstelle
ailes	flügel
machines	maschinen
julie	julie
institution	institution
donna	donna
caen	caen
organisations	organisationen
varsovie	warschau
présidentielle	präsidentschafts
compter	zählen
south	south
normale	normal
résolution	auflösung
pilotes	treiber
conquête	eroberung
colonie	kolonie
hélène	hélène
hélène	helene
besoins	bedürfnisse
inférieur	unterer
cannes	cannes
neige	schnee
discussions	diskussionen
installer	installieren
discipline	disziplin
responsabilité	haftung
paysage	landschaft
suffit	genügt
poissons	fische
violence	gewalt
coût	kosten
comics	comics
africain	afrikaner
bandes	bänder
vais	werde
cellules	zellen
fosse	grube
costumes	kostüme
johnny	johnny
espoir	hoffnung
jardins	gärten
médailles	medaillen
america	america
angers	angers
détails	details
déclaration	erklärung
colonne	spalte
monaco	monaco
fêtes	feste
gagner	gewinnen
dijon	dijon
invité	eingeladen
invité	gast
affiche	zeigt
affiche	plakat
outil	werkzeug
prêt	bereit
inventaire	bestandsaufnahme
violon	violine
élevage	zucht
remplacement	ersatz
islam	islam
battu	geschlagen
envoie	sendet
réduit	reduziert
traces	spuren
war	war
créateur	schöpfer
expliquer	erklären
environs	umgebung
coalition	koalition
intérêts	zinsen
fox	fox
inspecteur	detective
due	due
marais	sumpf
moines	mönche
kong	kong
chimie	chemie
prenant	nehmend
poisson	fisch
inter	inter
fruits	obst
passion	leidenschaft
chercheurs	forscher
chat	katze
stratégie	strategie
tirs	schüsse
semblent	scheinen
sarah	sarah
interprété	interpretiert
retrait	rücknahme
coopération	zusammenarbeit
archipel	archipel
géorgie	georgien
âme	seele
gothique	gotischen
bloc	block
méditerranée	mittelmeer
visiteurs	besucher
clan	clan
répond	antwortet
capital	kapital
caractérisée	charakterisiert
surnom	spitzname
express	express
électricité	elektrizität
facile	einfach
différent	unterschiedlich
découvrir	entdecken
changements	änderungen
fred	fred
chrétien	christlich
oxford	oxford
croatie	kroatien
ange	engel
gaston	gaston
robin	robin
récompenses	auszeichnungen
xiv	xiv
conflits	konflikte
remplace	ersetzt
cultures	kulturen
étudier	studieren
lundi	montag
viii	viii
andrea	andrea
accessible	zugänglich
universités	universitäten
virginie	virginia
avantage	vorteil
partout	überall
engagé	engagiert
objectifs	ziele
ann	ann
écossais	schottischen
soirée	abend
mélange	mischung
mine	mine
costa	costa
alphonse	alphonse
state	state
acquis	erworben
lucien	lucien
support	support
sydney	sydney
qualifié	qualifiziert
introduit	eingeführt
caractéristique	merkmal
nba	nba
howard	howard
charlie	charlie
guitariste	gitarrist
évêques	bischöfe
défendre	verteidigen
conséquences	konsequenzen
elizabeth	elizabeth
recevoir	empfangen
brest	brest
pianiste	pianist
friedrich	friedrich
occupé	beschäftigt
occupé	besetzt
musées	museen
traversée	überfahrt
réussi	geschafft
armand	armand
centaines	hunderte
maîtrise	beherrschung
encyclopédique	enzyklopädische
réédition	neuauflage
calcul	berechnung
rêve	traum
mathieu	mathieu
camille	camille
dérivés	derivate
plaque	platte
ffffff	ffffff
body	body
nez	nase
démocratie	demokratie
meurtre	mord
barre	stab
métropole	metropole
neuvième	neunte
minute	minute
élite	elite
applications	anwendungen
aîné	ältester
verre	glas
équipement	ausrüstung
queue	schwanz
ivoire	elfenbein
hong	hong
chantier	baustelle
ivan	ivan
ivan	iwan
design	design
pistes	pisten
exécutif	exekutive
jonathan	jonathan
jacob	jacob
mythologie	mythologie
belgrade	belgrad
revenu	einkommen
guinée	guinea
basilique	basilika
girl	girl
confédération	konföderation
dessinateur	zeichner
jimmy	jimmy
arrêter	anhalten
rallye	rallye
valence	valencia
amitié	freundschaft
dossier	ordner
diego	diego
maladies	krankheiten
oiseau	vogel
ump	ump
péninsule	halbinsel
francesco	francesco
campagnes	kampagnen
compilation	zusammenstellung
terrestre	terrestrischen
budapest	budapest
représentations	vertretungen
noble	edel
ambassadeur	botschafter
opérateur	betreiber
possession	besitz
souvenir	erinnerung
forteresse	festung
ennemis	feinde
sections	abschnitte
viens	komm
engagement	engagement
engagement	verpflichtung
languedoc	languedoc
localités	ortschaften
quarante	vierzig
title	title
supprimé	gelöscht
douglas	douglas
lady	lady
listes	listen
boy	boy
arbitrage	schiedsverfahren
lecteur	player
idem	idem
tire	schieß
hop	hop
christopher	christopher
réduire	verringern
réduire	reduzieren
anderson	anderson
christine	christine
goût	geschmack
sélectionné	ausgewählt
venus	venus
miller	miller
dédié	gewidmet
exil	exil
terminé	abgeschlossen
cambridge	cambridge
sncf	sncf
ventes	vertrieb
ventes	verkauf
relative	relative
instruction	anweisung
cancer	krebs
donald	donald
agents	bediensteten
observation	beobachtung
fréquence	häufigkeit
dure	dauert
vins	weine
employés	angestellte
out	out
forum	forum
lanceur	trägerrakete
administrativement	administrativ
solaire	solar
alimentation	ernährung
neutre	neutral
orthodoxe	orthodoxen
citoyens	bürger
vladimir	wladimir
ouvriers	arbeiter
pseudonyme	pseudonym
humanité	menschlichkeit
clé	schlüssel
manuscrit	manuskript
déterminer	bestimmen
défaites	niederlagen
colline	hügel
divisions	abteilungen
gustave	gustave
continent	kontinent
ruines	ruinen
technologies	technologien
fais	mach
précis	präzise
picardie	picardie
porto	porto
bourbon	bourbon
difficulté	schwierigkeit
franz	franz
ombre	schatten
cousin	cousin
vapeur	dampf
interview	interview
bay	bay
colonnes	spalten
républicain	republikaner
attribué	zugewiesen
attribué	zugeordnet
stanley	stanley
muet	stumm
couvre	deckt
garçon	junge
western	western
vérifier	überprüfen
transmission	übermittlung
soldat	soldat
jersey	jersey
sénégal	senegal
option	option
pluie	regen
commentaires	kommentare
fpu	fpu
turin	turin
poitou	poitou
automatique	automatik
automatique	automatisch
compétences	zuständigkeiten
compétences	kompetenzen
extrêmement	extrem
neveu	neffe
mohamed	mohamed
hubert	hubert
cinquante	fünfzig
publicité	werbung
souverain	souverän
associés	assoziierten
chronique	chronik
charte	charta
renault	renault
arrivé	angekommen
préface	vorwort
échecs	schach
frais	frisch
pérou	peru
bloqué	blockiert
palette	palette
tramway	straßenbahn
amiens	amiens
louvre	louvre
marco	marco
lès	lès
offensive	offensive
amie	freundin
alias	alias
concentration	konzentration
series	series
précision	genauigkeit
passagers	passagiere
can	can
degré	grad
puissant	mächtig
puissant	leistungsfähig
départementale	landstrasse
correspondance	korrespondenz
hamilton	hamilton
partiellement	teilweise
tim	tim
organismes	organismen
juniors	junioren
visage	gesicht
country	country
danois	dänisch
montrer	zeigen
conférences	konferenzen
paramètres	einstellungen
réflexion	reflexion
philadelphie	philadelphia
that	that
prononciation	aussprache
actualité	aktuell
aube	dämmerung
aube	morgengrauen
mariée	braut
meuse	maas
billy	billy
répertoire	verzeichnis
mazovie	masowien
traditionnel	traditionell
lacs	seen
suprême	obersten
musulmans	muslime
ain	ain
sexe	geschlecht
séjour	aufenthalt
andy	andy
norme	norm
appareils	geräte
gordon	gordon
ordinateur	computer
repose	beruht
ligues	ligen
nick	nick
surprise	überraschung
juif	jüdisch
efficace	effizient
bulgarie	bulgarien
grecs	griechen
séparation	trennung
perdre	verlieren
puy	puy
votes	abstimmungen
tibet	tibet
spectateurs	zuschauer
stars	stars
baroque	barock
secteurs	sektoren
will	will
tournois	turniere
gagné	gewonnen
distinction	unterscheidung
four	ofen
garder	halten
venezuela	venezuela
triple	triple
vécu	gelebt
vécu	lebte
high	high
autel	altar
continuer	weiter
propriétaires	eigentümer
efforts	bemühungen
roussillon	roussillon
influencé	beeinflusst
vacances	urlaub
treize	dreizehn
exclusivement	ausschließlich
plat	flach
azur	azur
reconstruction	wiederaufbau
columbia	columbia
choisir	wählen
administrateurs	administratoren
global	global
bruce	bruce
consensus	konsens
troupe	truppe
sauvage	wild
consulté	konsultiert
clip	clip
optique	optik
fantastique	fantastisch
navigation	navigation
augmenter	erhöhen
instant	augenblick
synthèse	synthese
phare	phare
surveillance	überwachung
déplacement	abbau
championship	championship
prieuré	prieuré
désert	wüste
ibn	ibn
nam	nam
back	back
enseignant	lehrer
bourse	börse
pedro	pedro
dépôt	einzahlung
exactement	genau
hollywood	hollywood
tunis	tunis
presses	pressen
prusse	preußen
théologie	theologie
laura	laura
sun	sun
augustin	augustin
peint	gemalt
froid	kalt
réputation	ruf
not	not
syrie	syrien
flandre	flandern
villeneuve	villeneuve
alexis	alexis
lublin	lublin
playstation	playstation
ronde	runde
allen	allen
colonies	kolonien
responsables	verantwortliche
responsables	verantwortlichen
pékin	peking
apparence	aussehen
apparence	erscheinungsbild
couche	schicht
changé	verändert
châteaux	schlösser
animateur	animator
master	master
mathématicien	mathematiker
autonomie	autonomie
expansion	expansion
particuliers	privatpersonen
dragons	drachen
numéros	nummern
besançon	besançon
giuseppe	giuseppe
malheureusement	leider
provisoire	vorläufig
veuve	witwe
apporter	mitbringen
nicole	nicole
programmation	programmierung
cameroun	kamerun
soins	pflege
linguistique	sprachliche
exercice	übung
lah	lah
bot	bot
fonctionne	funktioniert
botanique	botanischen
amoureux	verliebt
east	east
amélioration	verbesserung
successivement	nacheinander
manchester	manchester
vouloir	wollen
virus	viren
iso	iso
fermeture	schließung
voile	segeln
aisne	aisne
monarchie	monarchie
spécialisé	spezialisiert
soutenu	unterstützt
décisions	entscheidungen
décisions	beschlüsse
remarquable	bemerkenswert
yougoslavie	jugoslawien
hugues	hugues
zurich	zürich
assassinat	ermordung
restaurant	restaurant
first	first
abandonné	aufgegeben
fernando	fernando
wilhelm	wilhelm
tribu	stamm
hebdomadaire	wöchentlich
belges	belgier
rotation	rotation
apporte	bringt
tiré	gezogen
tiré	geschossen
attitude	haltung
transféré	verlegt
jugement	urteil
bible	bibel
cyrillique	kyrillisch
clark	clark
rayon	strahl
paulo	paulo
civils	zivilisten
nécessité	notwendigkeit
limoges	limoges
têtes	köpfe
métal	metall
space	space
facteur	faktor
rangers	rangers
ryan	ryan
fini	fertig
road	road
épée	schwert
banlieue	vorort
courts	kurze
toulon	toulon
pic	pic
voisins	nachbarn
fantasy	fantasy
jouant	spielend
opposé	entgegengesetzt
irak	irak
bruges	brügge
progrès	fortschritt
soixante	sechzig
tonnes	tonnen
dieux	götter
copie	kopie
intégré	integriert
jason	jason
carbone	kohlenstoff
modifié	geändert
mâle	männlich
ouvrir	öffnen
pétrole	erdöl
normal	normal
illinois	illinois
jura	jura
attaché	gefesselt
corporation	corporation
hervé	hervé
cible	ziel
africaine	afrikanische
extra	extra
dark	dark
morceau	stück
dixième	zehnte
pyramide	pyramide
pasteur	pastor
nintendo	nintendo
adopté	adoptiert
entraînement	training
kelly	kelly
arnaud	arnaud
actifs	vermögenswerte
volontaires	freiwillige
filiale	tochtergesellschaft
plaisir	vergnügen
limousin	limousin
époux	ehemann
organiser	organisieren
lisa	lisa
individuel	individuell
anime	anime
croire	glauben
domination	herrschaft
domination	dominanz
débats	debatten
moto	motorrad
tunnel	tunnel
échapper	entkommen
fenêtres	fenster
mineur	minderjährigen
vertical	senkrecht
équilibre	gleichgewicht
variable	variable
sanctuaire	heiligtum
illustrations	illustrationen
slovaquie	slowakei
paramètre	parameter
psychologie	psychologen
constantinople	konstantinopel
fouilles	ausgrabungen
diplômé	absolvent
sel	salz
découvertes	entdeckungen
héritage	erbschaft
hitler	hitler
commencer	beginnen
madagascar	madagaskar
candidature	bewerbung
théorème	satz
télé	glotze
expériences	erfahrungen
étudié	studiert
étudié	studierte
jeff	jeff
buenos	buenos
massacre	massaker
potentiel	potential
potentiel	potenzial
annuel	jährlich
voisin	nachbar
représenter	repräsentieren
free	free
dialogue	dialog
présidente	vorsitzende
évidemment	offensichtlich
thérèse	thérèse
grotte	höhle
pain	brot
toit	dach
opus	opus
individu	einzelperson
russell	russell
death	death
réduction	verringerung
alberto	alberto
tension	spannung
soviétiques	sowjets
secrets	geheimnisse
intégration	integration
wimbledon	wimbledon
venu	gekommen
rythme	rhythmus
intervient	interveniert
voulait	wollte
montré	gezeigt
rupture	bruch
vague	welle
décor	dekor
maintien	aufrechterhaltung
signal	signal
poitiers	poitiers
otto	otto
steven	steven
suicide	selbstmord
accords	vereinbarungen
margaret	margaret
périodes	perioden
mentionné	erwähnt
hollande	holland
crédit	kredit
crédit	gutschrift
xvi	xvi
librairie	buchhandlung
audio	audio
vosges	vogesen
dôme	kuppel
reproduction	reproduktion
christianisme	christentum
parcs	parks
entendu	gehört
hasard	zufall
dispositif	vorrichtung
pouvaient	konnten
acier	stahl
réélu	wiedergewählt
traditions	traditionen
générique	generische
civilisation	zivilisation
silence	schweigen
admis	zugelassen
isère	isère
raoul	raoul
publier	veröffentlichen
arguments	argumente
contribue	beiträgt
lait	milch
matt	matt
antenne	antenne
charbon	kohle
éponyme	namensgeber
maxi	maxi
archéologie	archäologie
agir	handeln
financement	finanzierung
uefa	uefa
soutenir	unterstützen
traducteur	übersetzer
ambassade	botschaft
miami	miami
men	men
dur	hart
dénomination	bezeichnung
constante	konstante
constante	konstant
inclus	inbegriffen
inclus	inklusive
two	two
fruit	frucht
montant	betrag
journalistes	journalisten
légère	leichte
incluant	inklusive
miguel	miguel
marbre	marmor
sicile	sizilien
clients	kunden
souvenirs	erinnerungen
insectes	insekten
prisonnier	häftling
edmond	edmond
interdiction	verbot
transition	übergang
durable	nachhaltig
mar	mar
intelligence	intelligenz
photographies	fotografien
payer	bezahlen
libéré	freigegeben
chaleur	wärme
chaleur	hitze
catalogne	katalonien
blog	blog
square	square
ingénieurs	ingenieure
indonésie	indonesien
chaussée	fahrbahn
variétés	sorten
loisirs	freizeit
lambert	lambert
liquide	flüssig
capacités	kapazitäten
gary	gary
présidents	präsidenten
étages	etagen
power	power
écliptique	ekliptik
beauté	schönheit
indépendants	selbständige
indépendants	unabhängige
achat	kauf
camps	lagern
marques	marken
boulogne	boulogne
réponses	antworten
admin	admin
gallo	gallo
solutions	lösungen
inauguré	eingeweiht
rev	rev
cuba	kuba
testament	testament
attaquer	angreifen
seize	sechzehn
old	old
great	great
décoration	dekoration
fermé	geschlossen
times	times
alphabet	alphabet
jordan	jordan
schéma	schema
contribué	beigetragen
contribué	beigesteuert
campus	campus
pie	pie
dis	sag
vues	ansichten
resté	geblieben
solide	solide
philip	philip
fiat	fiat
charges	lasten
bureaux	büros
atmosphère	atmosphäre
réception	rezeption
dave	dave
mourir	sterben
nelson	nelson
témoin	zeuge
règlement	verordnung
horreur	horror
manifeste	manifest
pirates	piraten
fenêtre	fenster
délégation	delegation
acquisition	erwerb
inclut	einschließt
inclut	beinhaltet
défini	definiert
clés	schlüssel
placer	platzieren
nobel	nobel
adultes	erwachsene
spectacles	aufführungen
voisine	nachbarin
emblème	emblem
alternative	alternative
littéralement	buchstäblich
trace	trace
ours	bär
portraits	porträts
wild	wild
limité	limitiert
bla	bla
loir	loir
normes	normen
refuge	zuflucht
nourriture	nahrung
facteurs	faktoren
devaient	mussten
dynamique	dynamik
ross	ross
boris	boris
branches	zweige
démission	rücktritt
aragon	aragon
batailles	schlachten
assassiné	ermordet
alpin	alpin
illustré	illustriert
colin	colin
consulter	konsultieren
zéro	null
atp	atp
gironde	gironde
réunit	vereinigt
intéressant	interessant
remix	remix
fra	fra
identique	identisch
clôture	zaun
cheveux	haare
varie	variiert
respecter	respektieren
apparemment	anscheinend
apparemment	scheinbar
bbc	bbc
trio	dreier
communistes	kommunisten
lourd	schwer
lourd	schwere
obligatoire	obligatorisch
dordogne	dordogne
moore	moore
explosion	explosion
relégation	relegation
honoré	geehrt
exerce	ausübt
augmente	erhöht
esclaves	sklaven
médecins	ärzte
nathalie	nathalie
quentin	quentin
désir	wunsch
grégoire	gregor
comtesse	gräfin
paysans	bauern
complexes	komplexe
noyau	kernel
germanique	germanischen
sportifs	sportler
ohio	ohio
motifs	motive
lisbonne	lissabon
fleur	blume
turc	türkisch
charentes	charentes
increment	increment
réserves	rücklagen
navarre	navarra
hambourg	hamburg
envoyer	senden
morgan	morgan
définir	definieren
oblast	oblast
micro	mikro
oriental	oriental
maría	maría
wilaya	wilaya
géant	riese
géant	riesen
consul	konsul
lourdes	lourdes
logiciels	software
paradis	paradies
relégué	absteiger
ian	ian
anjou	anjou
tempête	sturm
abréviations	abkürzungen
constantin	konstantin
embouchure	mündung
bonheur	glück
moine	mönch
négociations	verhandlungen
oliver	oliver
bâle	basel
conclusion	schlussfolgerung
nîmes	nîmes
franck	franck
stockholm	stockholm
accent	akzent
efficacité	effizienz
cuivre	kupfer
concile	konzil
cents	cent
ferrari	ferrari
apostolique	apostolischen
viande	fleisch
probable	wahrscheinliche
ken	ken
escalier	treppe
diable	teufel
herbert	herbert
berne	bern
roberto	roberto
chante	singt
jerry	jerry
talent	talent
invités	gäste
town	town
natation	schwimmen
apprendre	lernen
sols	böden
détruire	zerstören
castille	kastilien
movie	movie
syndrome	syndrom
alcool	alkohol
elena	elena
passages	passagen
inspiration	inspiration
retiré	zurückgezogen
sombre	dunkel
data	data
habituellement	normalerweise
nécessite	erfordert
dead	dead
racine	wurzel
fidèle	treu
lecteurs	leser
roux	roux
illustration	illustration
intégrer	integrieren
intégrer	einbetten
écologie	ökologie
spécialistes	spezialisten
ajouté	hinzugefügt
ultime	ultimative
pseudo	pseudo
constructions	bauten
variations	variationen
descente	abstieg
punk	punk
sucre	zucker
cite	isced
symphonie	symphonie
vêtements	kleidung
dance	dance
explication	erklärung
différences	unterschiede
trad	trad
variante	variante
redirection	umleitung
stone	stone
bottom	bottom
duchesse	herzogin
play	play
abraham	abraham
couvert	bedeckt
précédemment	zuvor
délégué	delegierter
délégué	delegiert
logement	unterkunft
phases	phasen
tribus	stämme
astronome	astronom
graveur	brenner
wikimedia	wikimedia
carter	carter
francfort	frankfurt
flèche	pfeil
#ffffff	#ffffff
experts	experten
attentat	anschlag
arles	arles
colorado	colorado
feuille	blatt
coupes	schnitte
coupes	schalen
dep	dep
michigan	michigan
descendants	nachkommen
khan	khan
indre	indre
finlandais	finnischen
enfer	hölle
districts	distrikte
inutile	nutzlos
inutile	unnötig
déchets	abfälle
bell	bell
manuscrits	manuskripte
atlanta	atlanta
essence	benzin
séminaire	seminar
vancouver	vancouver
orthographe	rechtschreibung
lucas	lucas
biologie	biologie
massachusetts	massachusetts
essayer	versuchen
marchés	märkte
last	last
cellule	zelle
fou	verrückt
accepter	akzeptieren
heinrich	heinrich
coréen	koreanisch
courage	mut
moulins	mühlen
humour	humor
banques	banken
nommés	ernannt
battre	schlagen
clavier	tastatur
norvégien	norwegisch
cologne	köln
positif	positiv
minnesota	minnesota
plume	feder
paysages	landschaften
barry	barry
kansas	kansas
garros	garros
grève	streik
marchandises	waren
qualités	qualitäten
fichiers	dateien
patrice	patrice
pratiquement	praktisch
quatorze	vierzehn
arménie	armenien
norman	norman
allier	allier
leipzig	leipzig
fernand	fernand
bonaparte	bonaparte
rural	ländliche
codes	codes
warner	warner
malade	krank
arena	arena
imprimerie	druckerei
évaluer	bewerten
perspective	perspektive
garçons	jungen
edgar	edgar
walt	walt
tourner	drehen
impérial	imperial
sultan	sultan
liban	libanon
hermann	hermann
sociologie	soziologie
ballet	ballett
accusé	angeklagt
onu	uno
ernst	ernst
effort	aufwand
stuart	stuart
implique	impliziert
jette	wirft
index	index
téléphone	telefon
documentation	dokumentation
bouche	mund
queen	queen
hiérarchie	hierarchie
lyonnais	lyonnais
blessure	verletzung
équateur	ecuador
fine	fine
bourgeois	bourgeois
statues	statuen
anneau	ring
chambres	zimmer
youtube	youtube
xii	xii
sporting	sporting
pire	schlimmer
profite	genieße
terminus	endstation
abc	abc
masque	maske
combattre	bekämpfen
gloire	ruhm
protégé	geschützt
tâche	aufgabe
causes	ursachen
papillon	schmetterling
comparaison	vergleich
préparer	vorbereiten
vendée	vendée
illustre	veranschaulicht
automatiquement	automatisch
accepté	akzeptiert
pousse	wächst
luigi	luigi
grant	grant
globe	globus
procureur	staatsanwalt
ardennes	ardennen
atlas	atlas
caisse	kasse
génétique	genetik
ballon	ball
ballon	ballon
choc	schock
gérer	verwalten
romantique	romantisch
frappe	schlag
frappe	schlägt
philippines	philippinen
islamique	islamische
entouré	umgeben
anonyme	anonym
applique	wendet
assurance	versicherung
phil	phil
helsinki	helsinki
manager	manager
lawrence	lawrence
unesco	unesco
danny	danny
module	modul
enterré	begraben
bonus	bonus
théories	theorien
hot	hot
éliminatoires	vorrunde
uci	uci
diversité	vielfalt
garnison	garnison
résoudre	lösen
résistant	beständig
islande	island
janeiro	janeiro
macédoine	mazedonien
sculptures	skulpturen
investissement	investition
absolument	absolut
incident	vorfall
are	are
chêne	eiche
transformé	verwandelt
transformé	verarbeitet
adversaires	gegner
boys	boys
compagnon	begleiter
paolo	paolo
radical	radikal
partenariat	partnerschaft
entrées	einträge
stratégique	strategische
réfugiés	flüchtlinge
berger	berger
cache	zwischenspeicher
œufs	eier
tentatives	versuche
particularité	besonderheit
emma	emma
miles	meilen
miles	miles
distinguer	unterscheiden
doublé	verdoppelt
boxe	boxen
tarn	tarn
compagnons	gefährten
challenge	challenge
adolphe	adolphe
serpent	schlange
jeudi	donnerstag
georg	georg
parker	parker
isaac	isaac
isaac	isaak
foyer	foyer
invite	lädt
rencontrer	kennenlernen
étang	teich
symboles	symbole
vols	flüge
voûte	bogen
murray	murray
racines	wurzeln
houston	houston
équipé	ausgerüstet
équipé	ausgestattet
parfait	perfekt
roumain	rumänisch
affluents	nebenflüsse
mali	mali
repos	erholung
repos	ausruhen
gardes	wachen
gand	gent
romane	romanischen
romane	romane
vents	winde
rap	rap
circulaire	rundschreiben
fribourg	freiburg
décennies	jahrzehnte
family	family
uruguay	uruguay
esthétique	ästhetik
suzanne	suzanne
coloniale	kolonialen
adams	adams
wayne	wayne
malte	malta
spider	spider
ahmed	ahmed
anton	anton
citation	zitat
loiret	loiret
républicains	republikaner
indiens	indianer
appliquer	anwenden
tournant	wendepunkt
crédité	gutgeschrieben
tests	tests
neutralité	neutralität
sépare	trennt
bière	bier
arr	arr
arnold	arnold
julia	julia
industries	industrien
destin	schicksal
angel	angel
archéologiques	archäologischen
invention	erfindung
ottawa	ottawa
podium	podium
what	what
emplois	jobs
confusion	verwirrung
clergé	klerus
spécialement	speziell
mosquée	moschee
personnellement	persönlich
étrange	seltsam
crimes	verbrechen
nobles	edlen
vendre	verkaufen
maintenance	wartung
vicomte	vicomte
marshall	marshall
sorbonne	sorbonne
lang	lang
vallées	täler
inc	inkl
inc	inc
just	just
passa	verging
project	project
suites	suiten
contrôler	kontrollieren
pietro	pietro
colons	siedler
aurais	hätt
ferrand	ferrand
brésilienne	brasilianischen
arsenal	arsenal
adrien	adrien
larry	larry
majoritairement	überwiegend
policiers	polizisten
mayenne	mayenne
marion	marion
robe	kleid
baker	baker
normalement	normalerweise
jay	jay
stewart	stewart
phénomènes	phänomene
similaires	ähnliche
sage	weise
béton	beton
lions	lions
idéal	ideal
lionel	lionel
good	good
particules	teilchen
écurie	stall
soprano	soprano
kennedy	kennedy
harris	harris
shakespeare	shakespeare
masters	masters
refusé	abgelehnt
coureurs	läufer
extraits	auszüge
cadet	kadett
tribune	tribüne
hip	hip
coule	fließt
down	down
pau	pau
mineurs	minderjährige
dei	dei
commis	verübt
commis	begangen
physicien	physiker
bobby	bobby
dangereux	gefährlich
modes	modi
utilité	nützlichkeit
adoption	adoption
robinson	robinson
usines	fabriken
panneau	panel
pomme	apfel
media	media
inscriptions	aufdruck
messieurs	herren
nil	nil
rosa	rosa
bologne	bologna
seed	seed
justification	begründung
saga	saga
salvador	salvador
reconnaître	erkennen
principauté	fürstentum
volant	lenkrad
dents	zähne
may	may
algérien	algerischen
tommy	tommy
richesse	reichtum
subi	erlitten
acquiert	erwirbt
ports	häfen
terry	terry
mardi	dienstag
sprint	sprint
travaillant	arbeitend
matthew	matthew
cerveau	gehirn
fabrique	fertigt
arte	arte
voter	abstimmen
diplomate	diplomat
relatif	relative
sommets	gipfel
dramaturge	dramatiker
écologique	umweltfreundlich
écologique	ökologischen
joan	joan
architectes	architekten
transformer	verwandeln
eurent	hatten
habitude	gewohnheit
modeste	bescheiden
interface	schnittstelle
animé	animierte
animé	animiert
ludwig	ludwig
dérivé	abgeleitet
marcus	marcus
ottoman	osmanischen
universal	universal
imaginaire	imaginären
microsoft	microsoft
lens	lens
bucarest	bukarest
interventions	interventionen
témoignage	zeugnis
arizona	arizona
satellites	satelliten
wrestling	wrestling
circonstances	umstände
chancelier	kanzler
heart	heart
déclin	niedergang
déclin	rückgang
thermique	thermische
énorme	riesig
réformes	reformen
partenaires	partner
tombeau	grab
bruit	lärm
tchécoslovaquie	tschechoslowakei
devise	währung
universel	universellen
annie	annie
water	water
mercredi	mittwoch
limiter	begrenzen
sons	töne
circuits	schaltungen
mono	mono
clinique	klinik
pennsylvanie	pennsylvania
équation	gleichung
gouvernements	regierungen
cirque	zirkus
eddie	eddie
progression	progression
cooper	cooper
intégrée	integriert
vichy	vichy
tendances	tendenzen
dick	dick
urbanisme	stadtplanung
électeurs	wähler
simone	simone
thompson	thompson
variantes	varianten
aéronautique	luftfahrt
rochelle	rochelle
aigle	adler
salariés	beschäftigte
namur	namur
suspension	suspension
suspension	aussetzung
royaumes	königreiche
pen	pen
corriger	korrigieren
flag	flag
prière	gebet
dallas	dallas
xvie	xvie
admins	admins
nationalités	nationalitäten
colonisation	kolonisierung
women	women
pablo	pablo
appeler	anrufen
religions	religionen
wars	wars
lloyd	lloyd
chaud	heiß
year	year
fans	fans
adjectifs	adjektive
socks	socks
attraction	attraktion
abandonner	aufgeben
colère	zorn
cruz	cruz
réactions	reaktionen
symbolique	symbolische
transforme	verwandelt
patricia	patricia
races	rassen
way	way
renaud	renaud
naval	naval
león	león
armé	bewaffnet
graham	graham
digital	digital
sensible	empfindlich
compositions	kompositionen
walker	walker
vertu	tugend
rhénanie	rheinland
atteinte	erreicht
french	german
jennifer	jennifer
con	con
croit	glaubt
franklin	franklin
palestine	palästina
chiens	hunde
priori	priori
bryan	bryan
extraction	extraktion
berry	berry
kurt	kurt
eva	eva
préciser	angeben
mécanisme	mechanismus
angoulême	angoulême
séville	sevilla
geneviève	geneviève
bulgare	bulgarisch
morbihan	morbihan
soul	soul
mrs	mrs
alpha	alpha
abus	missbrauch
tube	rohr
miroir	spiegel
acheter	kaufen
alberta	alberta
rick	rick
primaires	primären
descendant	nachkomme
magie	magie
fromage	käse
exécuté	ausgeführt
exécuté	hingerichtet
indiana	indiana
estimé	geschätzt
conjoint	ehepartner
lie	lie
lie	verbindet
chaire	lehrstuhl
trinité	trinity
traduire	übersetzen
identifier	identifizieren
nov	nov
protocole	protokoll
galaxie	galaxie
blessures	verletzungen
jacqueline	jacqueline
batteur	schlagzeuger
roues	räder
stefan	stefan
allan	allan
harold	harold
vidéos	videos
pauvre	arme
confirmé	bestätigt
enseignants	lehrer
copenhague	kopenhagen
rayonnement	strahlung
ordinaire	ordentlichen
gênes	genua
alto	alto
sky	sky
sergent	sergeant
yyy	yyy
retard	verspätung
maxime	maxime
cleveland	cleveland
rebelles	rebellen
biologique	biologische
inventeur	erfinder
chars	panzer
sea	sea
hérault	hérault
couches	schichten
couches	windeln
renforcer	verstärken
manches	ärmel
brabant	brabant
bach	bach
coin	ecke
conventions	konventionen
rénovation	renovierung
débutant	anfänger
identification	identifizierung
typique	typisch
kate	kate
molière	molière
arcade	arcade
delta	delta
rafael	rafael
pakistan	pakistan
yvelines	yvelines
bloquer	blockieren
sant	sant
socialistes	sozialisten
kosovo	kosovo
nordique	nordische
preuves	beweise
afghanistan	afghanistan
ncaa	ncaa
people	people
helen	helen
arrêts	urteile
aimé	geliebt
projection	projektion
popularité	popularität
han	han
synagogue	synagoge
simpson	simpson
calvados	calvados
campbell	campbell
verdun	verdun
courbe	kurve
pan	pan
mercure	quecksilber
plomb	blei
synonyme	synonym
gymnastique	gymnastik
envie	lust
envie	neid
light	light
troyes	troyes
polo	polo
prononcé	ausgesprochen
constellation	konstellation
diane	diane
déplacer	verschieben
mitchell	mitchell
ngc	ngc
armoiries	wappen
commandes	bestellungen
mickey	mickey
légendes	legenden
africains	afrikaner
mercedes	mercedes
bâton	stock
cartons	kartons
raphaël	raphael
kiev	kiew
sac	tasche
flûte	flöte
plaques	platten
dispositions	bestimmungen
cratère	krater
annexe	anlage
annexe	anhang
hard	hard
feat	feat
ralph	ralph
leo	leo
traction	traktion
géologie	geologie
parlé	sprach
cnrs	cnrs
harvard	harvard
bowl	bowl
chasseur	jäger
java	java
sénateurs	senatoren
signer	unterschreiben
signer	unterzeichnen
trou	loch
permanent	ständigen
permanent	dauerhaft
put	put
lorient	lorient
matériau	werkstoff
neil	neil
copa	copa
ron	ron
sondage	umfrage
moon	moon
légale	gesetzlich
légale	gesetzliche
inspire	inspire
appartement	wohnung
diriger	leiten
diriger	lenken
pure	reine
pure	pure
pourcentage	prozentsatz
carrefour	kreuzung
evans	evans
alexandrie	alexandria
patients	patienten
susan	susan
garcía	garcía
dublin	dublin
harvey	harvey
justin	justin
dunkerque	dünkirchen
couramment	fließend
patient	patient
missouri	missouri
référendum	referendum
roses	rosen
pèlerinage	pilgerfahrt
robot	roboter
sony	sony
turcs	türken
calcaire	kalkstein
fame	fame
posé	gestellt
stockage	lagerung
réservé	reserviert
traductions	übersetzungen
url	url
wright	wright
jon	jon
río	río
brut	brutto
pur	rein
pur	reine
triangle	dreieck
pittsburgh	pittsburgh
défend	verteidigt
propagande	propaganda
convaincre	überzeugen
témoins	zeugen
sánchez	sánchez
législative	legislative
thaïlande	thailand
soin	obacht
militants	aktivisten
flamand	flämischen
hier	gestern
recettes	rezepte
quatuor	quartett
agnès	agnes
act	act
oublier	vergessen
conversion	umrechnung
conversion	umwandlung
folie	wahnsinn
orne	orne
dauphin	delphin
martina	martina
prototype	prototyp
magasins	geschäfte
athlètes	athleten
botaniste	botaniker
impulsion	impuls
stuttgart	stuttgart
luke	luke
températures	temperaturen
dépression	tiefstand
jorge	jorge
dean	dean
liverpool	liverpool
générations	generationen
bordure	umrandung
séquence	sequenz
polytechnique	polytechnique
placés	platziert
oct	okt
marge	marge
vatican	vatikan
woman	woman
apparitions	auftritte
bombe	bombe
croate	kroatisch
rachel	rachel
shanghai	shanghai
conduire	fahren
conduire	autofahren
capture	capture
barra	barra
disparaît	verschwindet
pourvoir	besetzen
timbres	briefmarken
déesse	göttin
lituanie	litauen
valenciennes	valenciennes
paragraphe	absatz
adn	dna
bec	auslauf
égal	gleich
hachette	hachette
situations	situationen
géométrie	geometrie
sexuelle	sexuell
gard	gard
nathan	nathan
semblable	ähnlich
finistère	finistère
possibilités	möglichkeiten
décennie	jahrzehnt
beaumont	beaumont
austin	austin
influences	einflüsse
century	century
like	like
gendarmerie	gendarmerie
estonie	estland
chypre	zypern
jun	jun
dell	dell
over	over
surfaces	oberflächen
sentiments	gefühle
qualifiés	qualifizierte
vitesses	geschwindigkeiten
canal+	canal+
instance	instanz
obligé	gezwungen
brouillon	entwurf
kings	kings
astronomie	astronomie
tombé	gefallen
escadron	geschwader
immatriculation	zulassung
claviers	tastaturen
mandats	mandate
sarthe	sarthe
istanbul	istanbul
témoignages	zeugnisse
laurence	laurence
consacrer	widmen
łódź	łódź
aviron	rudern
timbre	briefmarke
baptisé	getauft
mons	mons
théorique	theoretische
sean	sean
dégâts	schaden
arrondissements	arrondissements
considérablement	beträchtlich
louisiane	louisiana
absolue	absolute
spécialité	spezialität
prime	prämie
oracle	oracle
age	alter
melbourne	melbourne
polémique	polemik
vivants	lebend
compréhension	verständnis
field	field
habite	wohnt
catastrophe	katastrophe
démonstration	demonstration
thriller	thriller
creuse	creuse
greg	greg
nuits	nächte
lincoln	lincoln
volcan	vulkan
kent	kent
parlant	sprechend
grille	gitter
fernández	fernández
marvel	marvel
remarques	bemerkungen
spirou	spirou
sofia	sofia
hébreu	hebräisch
inhumé	beigesetzt
pat	pat
variables	variablen
vignoble	weingut
roue	rad
autorisé	zulässig
puissances	mächte
retenu	zurückgehalten
navigateur	navigator
navigateur	browser
albin	albin
organes	organe
business	business
causer	verursachen
sylvain	sylvain
compétence	kompetenz
décerné	verliehen
éliminer	eliminieren
fonctionnaires	beamte
démocrates	demokraten
bords	kanten
directrice	direktorin
fragments	fragmente
appuie	drück
seattle	seattle
bond	bond
mulhouse	mulhouse
missiles	raketen
ordonné	angeordnet
ordonné	befohlen
certifié	zertifiziert
chercheur	forscher
prépare	bereitet
innovation	innovation
combiné	kombiniert
ref	ref
amy	amy
turner	turner
ardèche	ardèche
fortifications	befestigungsanlagen
forest	forest
burkina	burkina
yonne	yonne
sachant	wissend
effectifs	personalbestand
devraient	sollten
répression	unterdrückung
blé	weizen
his	his
conrad	conrad
rousseau	rousseau
meyer	meyer
stable	stabil
correspondent	entsprechen
ecclésiastique	kirchlichen
fonctionnaire	beamter
catholicisme	katholizismus
rayons	speichen
height	height
silva	silva
linéaire	linear
commandé	bestellt
bretonne	bretonische
brevet	patent
mémorial	gedenkstätte
propulsion	antrieb
mythe	mythos
faso	faso
fire	fire
bouches	münder
mohammed	mohammed
grey	grey
prochaine	nächste
léonard	léonard
degrés	grad
flammarion	flammarion
philosophique	philosophische
styles	stile
doubs	doubs
nazis	nazis
guyane	guyana
talk	talk
elisabeth	elisabeth
aude	aude
alexandra	alexandra
caméra	kamera
andreas	andreas
legend	legend
régulier	regelmäßigen
mix	mix
sound	sound
immigration	einwanderung
connais	kenn
werner	werner
airlines	airlines
pollution	verschmutzung
garcia	garcia
fayard	fayard
marocain	marokkaner
filmographie	filmografie
hôte	gastgeber
revers	rückschlag
sergio	sergio
organe	organ
signification	bedeutung
todd	todd
debout	stehend
duel	duell
panama	panama
poétique	poetisch
enregistrements	aufzeichnungen
épaisseur	dicke
#aaaaaa	#aaaaaa
hunter	hunter
heureux	glücklich
alaska	alaska
august	august
law	law
bébé	baby
moments	momente
illustrateur	illustrator
dépendant	abhängig
perse	persien
diesel	diesel
phoenix	phoenix
lópez	lópez
erik	erik
délai	frist
magic	magic
solidarité	solidarität
peugeot	peugeot
piémont	piemont
chapeau	hut
vénus	venus
régiments	regimenter
portait	trug
ted	ted
uniforme	uniform
serment	eid
libéraux	liberalen
éliminé	eliminiert
déroulement	ablauf
scandale	skandal
débarquement	anlandung
edit	edit
jésuites	jesuiten
wta	wta
échoue	scheitert
isle	isle
sebastian	sebastian
ducs	herzöge
alphabétique	alphabetisch
juliette	juliette
harmattan	harmattan
protestants	protestanten
arrestation	festnahme
arrestation	verhaftung
daté	datiert
cristal	kristall
combinaison	kombination
radar	radar
malaisie	malaysia
nominations	ernennungen
repas	mahlzeit
éthique	ethik
hesse	hessen
arms	arms
halle	halle
luxe	luxus
estimée	geschätzt
maîtresse	herrin
lorenzo	lorenzo
rob	rob
casablanca	casablanca
dennis	dennis
mail	mail
qualifier	qualifizieren
compositeurs	komponisten
artisans	handwerker
cat	cat
wood	wood
bourges	bourges
témoigne	zeugt
strictement	strikt
tâches	aufgaben
fallait	musste
impératrice	kaiserin
marquer	markieren
chartres	chartres
décoré	verziert
condé	conde
détective	detektiv
cohen	cohen
sarkozy	sarkozy
pole	pole
wagner	wagner
mondes	welten
wurtemberg	württemberg
salomon	salomon
prouver	beweisen
dette	schulden
dream	dream
meurthe	meurthe
bibliothèques	bibliotheken
cru	weinlese
dessert	dessert
dessert	nachtisch
blake	blake
nationaliste	nationalistischen
expert	experte
normand	normand
holmes	holmes
renard	fuchs
esclavage	sklaverei
magnétique	magnetische
mississippi	mississippi
collègues	kollegen
ille	ille
graines	samen
rébellion	rebellion
rtl	rtl
nova	nova
percussions	percussion
tueur	mörder
envoyés	gesendete
galeries	galerien
apparente	scheinbare
provincial	provincial
auxerre	auxerre
libérer	befreien
munitions	munition
divine	göttliche
warren	warren
bouddhisme	buddhismus
opera	opera
concepts	konzepte
harmonie	harmonie
magnus	magnus
révélé	offenbart
parlementaires	parlamentarier
collins	collins
blocs	blöcke
acheté	gekauft
bolivie	bolivien
coupé	geschnitten
#aaa	#aaa
législation	gesetzgebung
cerf	hirsch
révolutionnaires	revolutionäre
palatinat	pfalz
poméranie	pommern
sylvie	sylvie
posthume	posthume
wolfgang	wolfgang
mers	meere
lost	lost
johan	johan
cbs	cbs
reconstruit	umgebaut
canaux	kanäle
figaro	figaro
exercer	ausüben
envergure	spannweite
boucle	schleife
maçonnerie	mauerwerk
slovénie	slowenien
coordination	koordination
talents	talente
diplomatique	diplomatische
doux	süßen
pères	väter
partagé	geteilt
joint	dichtung
syndicats	gewerkschaften
nigeria	nigeria
lou	lou
gaulois	gallier
émilie	emilia
convaincu	überzeugt
nacional	nacional
leonard	leonard
concession	konzession
hainaut	hennegau
dérive	drift
eurovision	eurovision
égyptien	ägyptischen
naturaliste	naturforscher
juges	richter
hms	hms
avantages	vorteile
prévention	prävention
keith	keith
dommages	schaden
organique	organisch
impôt	steuer
vengeance	rache
bombardement	bombardierung
guadeloupe	guadeloupe
violoncelle	cello
impliqué	beteiligt
memorial	memorial
sfondo	sfondo
stage	praktikum
chantiers	baustellen
bros	bros
demain	morgen
nasa	nasa
mensuel	monatlich
équipée	ausgerüstet
équipée	ausgestattet
dakar	dakar
souveraineté	souveränität
profond	tief
occitan	okzitanisch
continuité	kontinuität
systématiquement	systematisch
attend	wartet
intensité	intensität
protéines	proteine
hollandais	holländisch
intéressé	interessiert
décrire	beschreiben
sauveur	erlöser
éclairage	beleuchtung
betty	betty
haye	haag
rochefort	rochefort
martinique	martinique
esp	esp
ita	ita
halte	halt
baccalauréat	abitur
gonzález	gonzález
appliquée	angewandte
atlético	atlético
joachim	joachim
sèvres	sèvres
gallois	waliser
jupiter	jupiter
protestante	protestantische
wwe	wwe
grace	grace
précipitations	niederschlag
marianne	marianne
bohême	böhmen
posée	gestellt
sidi	sidi
console	konsole
santos	santos
tombes	gräber
adolf	adolf
réservoir	tank
approfondir	vertiefen
more	more
linda	linda
vocabulaire	vokabular
vocabulaire	wortschatz
missile	rakete
utiles	nützliche
glasgow	glasgow
harrison	harrison
wallonie	wallonien
transept	querschiff
anneaux	ringe
cyr	cyr
fuir	fliehen
sentier	pfad
richelieu	richelieu
get	get
croisade	kreuzzug
boxeur	boxer
fifa	fifa
critère	kriterium
stanislas	stanislas
tensions	spannungen
lucie	lucie
rica	rica
casse	bricht
immobilier	immobilien
brigitte	brigitte
fresques	fresken
pattes	pfoten
économiste	ökonom
économiste	wirtschaftswissenschaftler
verbe	verb
bull	bull
adopter	adoptieren
craig	craig
évalué	bewertet
rond	rund
bnf	bnf
rudolf	rudolf
pokémon	pokémon
linux	linux
fabricant	hersteller
syntaxe	syntax
celtique	keltischen
singapour	singapur
michelle	michelle
joie	freude
costume	kostüm
hymne	hymne
douleur	schmerz
restauré	restauriert
gay	homosexuell
gay	schwul
vitraux	glasmalereien
mannequin	model
intense	intensiv
appartiennent	gehören
vegas	vegas
chimiste	chemiker
flash	flash
pacte	pakt
analyses	analysen
excellence	exzellenz
fritz	fritz
corruption	korruption
dépenses	ausgaben
vampire	vampir
comtés	grafschaften
platine	platin
perrin	perrin
pin	pin
angelo	angelo
moreau	moreau
haïti	haiti
nécessairement	notwendigerweise
european	european
cécile	cécile
return	return
abside	apsis
continu	kontinuierliche
rire	lachen
créations	kreationen
coupable	schuldig
report	report
monténégro	montenegro
terreur	terror
temporaire	vorübergehende
temporaire	temporär
wang	wang
brooklyn	brooklyn
ultra	ultra
fourni	bereitgestellt
sonde	sonde
baltimore	baltimore
télécommunications	telekommunikation
assurances	versicherungen
vélo	fahrrad
cloche	glocke
stabilité	stabilität
marketing	marketing
essonne	essonne
touché	berührt
nicholas	nicholas
exploitant	betreiber
végétation	vegetation
souffle	atem
pol	pol
diagnostic	diagnose
caraïbes	karibik
casino	kasino
musulman	muslim
observé	beobachtete
observé	beobachtet
appris	gelernt
mountain	mountain
fan	fan
sara	sara
remarqué	bemerkt
taïwan	taiwan
müller	müller
mammifères	säugetiere
potter	potter
doré	goldenen
toscane	toskana
rêves	träume
chômage	arbeitslosigkeit
signaler	melden
marina	marina
antilles	antillen
xbox	xbox
contacts	kontakte
poudre	pulver
avertissement	warnung
continental	continental
frederick	frederick
géré	verwaltet
théologien	theologe
algorithme	algorithmus
minuit	mitternacht
buste	büste
humide	feucht
catalan	katalanisch
contrats	verträge
censure	zensur
chapelles	kapellen
ménage	haushalt
bush	bush
marathon	marathon
solitaire	einsam
lombardie	lombardei
lazare	lazare
aveyron	aveyron
baies	beeren
beauvais	beauvais
avr	avr
perpignan	perpignan
peste	pest
wallace	wallace
instructions	anweisungen
controverse	kontroverse
aaron	aaron
soudan	sudan
lama	lama
détenu	häftling
murphy	murphy
divorce	scheidung
cook	cook
manhattan	manhattan
hardy	hardy
parme	parma
paiement	zahlung
fair	fair
systématique	systematische
rémy	rémy
prochain	nächste
morris	morris
survie	überleben
collégiale	kollegiale
hydrogène	wasserstoff
natural	natural
igor	igor
métaux	metalle
parrain	pate
km²	km²
révélation	offenbarung
hudson	hudson
avoue	gestehe
fabrice	fabrice
gravité	schwerkraft
gravité	schwere
valérie	valerie
groupement	gruppierung
belfort	belfort
pente	steigung
multi	multi
adhésion	mitgliedschaft
kid	kid
apple	apple
karen	karen
drôme	drôme
nazi	nazi
chanoine	domherr
narrateur	erzähler
complément	ergänzung
futurs	künftigen
traverser	überqueren
traverser	durchqueren
pacific	pacific
dons	spenden
patrie	vaterland
malo	malo
sèche	trocken
oxygène	sauerstoff
molécules	moleküle
céramique	keramik
uss	uss
judaïsme	judentum
pauvreté	armut
souligne	unterstreicht
africa	africa
exemplaire	exemplar
exemplaire	vorbildlich
wings	wings
enregistrer	speichern
monstre	monster
acides	säuren
morales	morales
perry	perry
roubaix	roubaix
brève	kurze
anthologie	anthologie
substance	substanz
geste	geste
matrice	matrix
nfl	nfl
sardaigne	sardinien
escrime	fechten
perception	wahrnehmung
charleroi	charleroi
axes	achsen
significations	bedeutungen
mayer	mayer
commonwealth	commonwealth
retenue	zurückhaltung
gregory	gregory
arménien	armenischen
domestique	häusliche
étymologie	etymologie
composants	komponenten
rival	rivalen
patriarche	patriarchen
dominant	dominierende
julian	julian
carburant	kraftstoff
voler	fliegen
dubois	dubois
vaucluse	vaucluse
capturé	gefangen
jet	jet
riz	reis
constance	konstanz
guatemala	guatemala
extraordinaire	außerordentliche
chan	chan
médicis	medici
doyen	dekan
bridge	bridge
créatures	kreaturen
otan	nato
indispensable	unverzichtbar
révision	revision
const	const
bulle	blase
alessandro	alessandro
pete	pete
médicaments	medikamente
cricket	cricket
ancêtres	vorfahren
olga	olga
touristes	touristen
terrible	schrecklich
blood	blood
battle	battle
hilaire	hilaire
confondre	verwechseln
barrière	barriere
soie	seide
essayé	versuchte
essayé	versucht
acoustique	akustik
colonial	colonial
amicalement	freundschaftlich
intellectuelle	geistigen
aluminium	aluminium
composées	asteraceae
piège	falle
biélorussie	weißrussland
doc	doc
citations	zitate
tragédie	tragödie
mozart	mozart
organiste	organist
excellent	ausgezeichnet
hart	hart
hôtels	hotels
arras	arras
horizon	horizont
silver	silver
pauline	pauline
hugh	hugh
amphibiens	amphibien
durand	durand
océanie	ozeanien
kenya	kenia
pilier	säule
diamant	diamant
derby	derby
tennessee	tennessee
chaos	chaos
chanter	singen
abrégé	abgekürzt
fusil	gewehr
serbes	serben
maintient	unterhält
marx	marx
reliques	reliquien
roberts	roberts
broadway	broadway
législatif	legislative
rotterdam	rotterdam
salaire	lohn
rappeur	rapper
watson	watson
ingénierie	ingenieurwesen
bayonne	bayonne
clara	clara
bataillons	bataillone
pérez	pérez
magistrat	magistrat
ethnique	ethnische
comarque	comarca
haies	hecken
flanc	flanke
randonnée	wandern
chambéry	chambéry
vignes	reben
contrainte	zwang
folk	folk
portails	portale
billets	eintrittskarten
apogée	höhepunkt
antarctique	antarktis
conducteur	fahrer
sphère	sphäre
lévy	lévy
libye	libyen
chirurgie	chirurgie
sent	riecht
oublié	vergessen
résidences	residenzen
grammaire	grammatik
critics	critics
yann	yann
balles	kugeln
balles	bälle
légendaire	legendär
tigre	tiger
compromis	kompromiss
horloge	uhr
middle	middle
séoul	seoul
parts	anteile
partager	teilen
pluriel	plural
omar	omar
monica	monica
rey	rey
dépôts	einlagen
josef	josef
michèle	michèle
pommes	äpfel
vannes	ventile
haine	hass
motte	motte
poussée	erhöhung
giorgio	giorgio
picard	picard
nommer	ernennen
set	set
lettonie	lettland
fermes	bauernhöfe
copies	kopien
restaurer	wiederherstellen
annecy	annecy
edwards	edwards
raid	raid
english	english
distances	entfernungen
plafond	decke
plafond	obergrenze
piscine	schwimmbad
donnés	gespendet
minorité	minderheit
california	california
ronald	ronald
charité	nächstenliebe
sienne	siena
emily	emily
explications	erklärungen
explications	erläuterungen
abel	abel
dessiné	gezeichnet
about	about
séparé	getrennt
graphe	graph
enregistrée	eingetragen
archéologue	archäologe
recommandations	empfehlungen
plainte	beschwerde
hippolyte	hippolyte
idéologie	ideologie
summer	summer
cage	käfig
préserver	bewahren
préserver	konservieren
souverains	herrscher
gaule	gallien
martine	martine
indochine	indochina
ménages	haushalte
buffalo	buffalo
juriste	jurist
démographie	demographie
sonate	sonate
regarde	schau
joueuses	spielerinnen
suffixe	suffix
corde	seil
geoffroy	geoffroy
oklahoma	oklahoma
documentaires	dokumentarfilme
sep	sep
pâte	teig
xviii	xviii
organisateur	veranstalter
papa	papa
florent	florent
archidiocèse	erzbistum
ordinateurs	computer
tables	tische
bassiste	bassist
jessica	jessica
gang	gang
servit	diente
martial	martial
bouton	schaltfläche
toucher	berührung
now	now
combattant	kämpfer
tropicale	tropischen
fossiles	fossilen
citadelle	zitadelle
plastique	kunststoff
exister	existieren
décider	entscheiden
menaces	bedrohungen
restée	geblieben
ventre	bauch
vicaire	vikar
plages	strände
barrages	dämme
mayence	mainz
brasserie	brauerei
prestige	prestige
châtillon	châtillon
missionnaire	missionar
rico	rico
protestant	protestant
spirituel	spirituelle
spirituel	geistig
priorité	priorität
rivalité	rivalität
valentin	valentin
problématique	problemstellung
précédé	vorausgegangen
danseuse	tänzerin
conforme	konform
earth	earth
violent	gewalttätig
démon	dämon
arcades	arkaden
madonna	madonna
sourire	lächeln
carrés	quadrate
sommeil	schlaf
digne	würdig
chirurgien	chirurg
défi	herausforderung
rite	ritus
consulat	konsulat
schmidt	schmidt
indigènes	eingeborenen
magnifique	wunderschön
classic	classic
hôpitaux	krankenhäuser
divinité	gottheit
ukrainien	ukrainisch
amanda	amanda
afro	afro
démontrer	demonstrieren
intellectuels	intellektuelle
entente	absprache
stevens	stevens
trilogie	trilogie
précieux	wertvoll
danube	donau
centenaire	hundertjährigen
donjon	kerker
jul	jul
affluence	andrang
caps	caps
légal	gesetzliche
légal	legal
incapable	unfähig
prévenir	vorbeugen
batman	batman
tibétain	tibetischen
carmen	carmen
jungle	dschungel
condamnation	verurteilung
légitime	legitim
let	let
biodiversité	biodiversität
lys	lys
cou	hals
accidents	unfälle
blois	blois
kazakhstan	kasachstan
spectre	spektrum
transcription	transkription
violoniste	geiger
achille	achilles
édit	edikt
sandra	sandra
una	una
hésite	zögert
élémentaire	elementare
recrutement	einstellung
rohan	rohan
terminal	terminal
explorer	erforschen
partition	partition
couples	paare
ana	ana
conservateurs	konservierungsmittel
conservateurs	konservativen
rappel	rückruf
incarne	verkörpert
neuchâtel	neuenburg
orchestra	orchestra
cameron	cameron
miracle	wunder
amédée	amédée
gène	gen
formés	ausgebildet
cfa	cfa
anarchiste	anarchist
indo	indo
graphiques	grafiken
charlemagne	charlemagne
monique	monique
créature	kreatur
accusations	anschuldigungen
accusations	anklagen
apporté	mitgebracht
négatif	negativ
juger	beurteilen
opérateurs	operatoren
use	use
martínez	martínez
albanie	albanien
thé	tee
armor	armor
unit	unit
connexion	verbindung
opinions	meinungen
distribué	verteilt
tranche	tranche
wikipédiens	wikipedianer
sul	sul
dumas	dumas
coque	rumpf
cloud	cloud
confié	anvertraut
boutique	boutique
knight	knight
colloque	kolloquium
suspendu	ausgesetzt
felix	felix
under	under
mare	mare
exigences	anforderungen
homonyme	gleichnamigen
castro	castro
inventé	erfunden
sidney	sidney
ténor	tenor
aveugle	blind
espionnage	spionage
segment	segment
tabac	tabak
palace	palace
side	side
monarque	monarch
réunions	sitzungen
nbc	nbc
butler	butler
tissus	gewebe
suffisante	ausreichend
spencer	spencer
connecticut	connecticut
afficher	anzeigen
dominante	dominante
dominante	beherrschenden
quels	welche
hercule	herkules
forcé	gezwungen
forcé	erzwungen
solde	saldo
récolte	ernte
gustav	gustav
attaqué	angegriffen
oregon	oregon
cape	cape
diff	diff
infos	infos
monté	montiert
artificielle	künstliche
then	then
traitements	behandlungen
leslie	leslie
serpents	schlangen
cuir	leder
utah	utah
carnaval	karneval
essayiste	essayist
cacher	ausblenden
come	come
neuilly	neuilly
kentucky	kentucky
ned	ned
probabilité	wahrscheinlichkeit
académique	akademischen
académique	akademische
roll	roll
accusation	anklage
châssis	fahrgestell
châssis	chassis
responsabilités	verantwortlichkeiten
responsabilités	zuständigkeiten
lyrique	lyrik
laser	laser
composant	komponente
sérieusement	ernsthaft
sauvetage	rettung
nina	nina
convoi	konvoi
atterrissage	landung
blaise	blaise
disputer	streiten
encre	tinte
hills	hills
remplir	ausfüllen
invitation	einladung
souffre	leidet
cercles	kreise
arche	arche
collaborateurs	mitarbeiter
viaduc	viadukt
gravures	gravuren
gratuit	kostenlos
