des	dos
des	das
les	as
les	os
une	um
une	uma
dans	em
catégorie	categoria
par	pelo
par	por
pour	para
sur	em
sur	sobre
qui	quem
qui	que
que	que
avec	com
son	som
plus	mais
pas	não
sont	são
elle	ela
aux	às
aux	aos
été	verão
comme	como
mais	mas
cette	essa
cette	esta
pop	pop
deux	duas
deux	dois
ses	suas
ses	seus
naissance	nascimento
aussi	também
france	frança
saint	santo
après	após
après	depois
fait	feito
notes	notas
entre	entre
sous	sob
même	mesmo
être	ser
nom	nome
français	francês
ont	têm
paris	paris
lui	ele
lieu	local
lieu	localização
autres	outros
décès	mortes
décès	morte
références	referências
liens	links
était	estava
était	era
commune	comum
ville	cidades
jean	joão
date	data
cest	est
peut	pode
depuis	desde
première	primeira
ans	anos
alors	então
externes	externas
externes	externos
site	site
premier	primeiro
ces	estes
ces	estas
http	http
ainsi	assim
film	filme
voir	ver
pays	país
source	fonte
ils	eles
grand	grande
tout	tudo
groupe	grupo
également	igualmente
également	também
titre	título
monde	mundo
nord	norte
années	anos
bien	bem
contre	contra
contre	contras
liste	lista
équipe	equipe
club	club
club	clube
sud	sul
partie	parte
avant	antes
non	não
très	muito
trois	três
articles	artigos
article	artigo
guerre	guerra
sans	sem
saison	temporada
fin	fim
vers	verso
année	ano
temps	tempo
plusieurs	vários
plusieurs	várias
faire	fazer
mars	marte
histoire	história
série	série
joueur	jogador
mai	maio
tour	torre
mort	morte
juin	junho
jpg	jpg
pierre	pedro
région	região
janvier	janeiro
avoir	ter
fois	vezes
autre	outro
autre	outros
septembre	setembro
juillet	julho
état	estado
église	igreja
octobre	outubro
place	praça
famille	família
états	estados
général	geral
avril	abril
insee	insee
tous	todos
politique	política
album	álbum
décembre	dezembro
août	agosto
novembre	novembro
avait	tinha
prix	preço
prix	preços
align	align
nouvelle	nova
février	fevereiro
département	departamento
grande	grande
peu	pouco
américain	americano
début	início
ligne	linha
suite	suite
suite	continuação
nationale	nacional
championnat	campeonato
encore	ainda
image	imagem
vie	vida
unis	unidos
lien	link
football	futebol
pendant	durante
jeux	jogos
moins	menos
ouest	oeste
page	página
nouveau	novo
vous	você
centre	centro
cours	cursos
cours	curso
partir	partir
village	vila
village	aldeia
université	universidade
louis	luís
nombre	número
quelques	alguns
leurs	suas
leurs	seus
siècle	século
coupe	copa
population	população
connexes	relacionados
connexes	relacionadas
homme	homem
communes	municípios
division	divisão
président	presidente
national	nacional
société	empresa
société	sociedade
quatre	quatro
cas	caso
jeu	jogo
genre	gênero
genre	tipo
musique	música
fils	fios
fils	filho
roi	rei
parti	partido
jour	dia
europe	europa
mise	aposta
forme	forma
new	new
ancien	antigo
origine	origem
ordre	ordem
château	castelo
école	escola
carrière	carreira
part	parte
deuxième	segunda
deuxième	segundo
bar	bar
charles	charles
points	pontos
ayant	tendo
paul	paulo
rue	rua
chef	chefe
père	pai
exemple	exemplo
trouve	encontra
durant	durant
rapport	relatório
art	arte
canton	cantão
dernier	último
dernier	última
type	tipo
habitants	habitantes
habitants	moradores
point	ponto
compte	conta
période	período
armée	exército
eau	água
marie	maria
discuter	discutir
discuter	conversar
projet	projeto
chaque	cada
anglais	inglês
province	província
john	john
international	internacional
international	international
conseil	conselho
françois	francisco
maison	casa
cela	isso
demande	pedido
fonction	função
étant	sendo
toujours	sempre
doit	deve
production	produção
certains	alguns
membre	membro
près	próximo
près	perto
meilleur	melhor
droit	direito
mois	mês
île	ilha
république	república
service	serviço
jacques	tiago
score	pontuação
langue	língua
dit	disse
dit	diz
gouvernement	governo
center	center
elles	elas
petit	pequeno
toutes	todas
argent	dinheiro
argent	prata
souvent	frequentemente
style	estilo
face	face
olympiques	olímpicos
quand	quando
top	top
ministre	ministro
mondiale	mundial
ensemble	conjunto
ensemble	juntos
ensemble	juntas
théâtre	teatro
épisode	episódio
scène	cena
situé	localizado
toute	toda
asp	asp
étaient	foram
étaient	eram
musée	museu
troisième	terceira
troisième	terceiro
nombreux	muitos
auteur	autor
nous	nós
système	sistema
création	criação
stade	estádio
tant	tanto
tard	tarde
reste	fica
reste	resto
text	text
seconde	segunda
seconde	segundo
roman	roman
jours	dias
édition	edição
éditions	edições
historique	histórico
œuvre	obra
sera	sera
sera	será
permet	permite
âge	idade
robert	robert
officiel	oficial
environ	aproximadamente
effet	efeito
version	versão
membres	membros
niveau	nível
champion	campeão
espèce	espécie
michel	miguel
raison	razão
modèle	modelo
travail	trabalho
femme	mulher
cinq	cinco
déjà	já
bas	baixo
texte	texto
terre	terra
allemagne	alemanha
from	from
compétition	competição
wikipédia	wikipédia
allemand	alemão
britannique	britânico
porte	porta
hommes	homens
italie	itália
bataille	batalha
corps	corpo
demi	demi
siège	cerco
siège	assento
personnes	pessoas
nommé	nomeado
route	estrada
finale	final
jeune	jovem
peuvent	podem
york	york
royaume	reino
ceux	aqueles
long	longo
long	long
latitude	latitude
base	base
études	estudos
communauté	comunidade
association	associação
militaire	militar
section	seção
section	secção
longitude	longitude
bronze	bronze
livre	livro
américaine	americana
haut	alto
suisse	suíça
canada	canadá
valign	valign
suivant	próximo
beaucoup	muito
beaucoup	muitos
dire	dizer
seul	sozinho
fille	menina
fille	filha
fille	rapariga
fille	garota
buts	gols
buts	golos
enfants	crianças
direction	direção
direction	direcção
position	posição
pouvoir	poder
but	gol
merci	obrigado
merci	obrigada
tête	cabeça
territoire	território
union	união
construction	construção
ancienne	antiga
premiers	primeiros
prend	toma
maire	prefeito
présente	apresenta
personnalité	personalidade
ligue	liga
public	público
pages	páginas
externe	externo
externe	externa
simple	simples
dernière	última
henri	henrique
chanson	canção
poste	posto
poste	post
culture	cultura
grâce	graça
développement	desenvolvimento
sortie	saída
empire	império
québec	quebec
david	david
loi	lei
équipes	equipes
côté	lado
mer	mar
haute	alta
vue	vista
espagne	espanha
mère	mãe
fichier	arquivo
fichier	ficheiro
nombreuses	muitas
acteur	ator
parcours	percursos
recherche	pesquisa
classement	classificação
code	código
double	dupla
double	duplo
entraîneur	treinador
web	web
arrondissement	arrondissement
directeur	diretor
joseph	josé
semble	parece
ici	aqui
vainqueur	vencedor
réalisé	realizado
existe	existe
existe	existo
six	seis
créé	criado
écrit	escreve
écrit	escrito
petite	pequena
bois	madeira
entreprise	empresa
retour	retorno
retour	volta
retour	voltar
numéro	número
principale	principal
sainte	santa
comté	condado
second	segundo
terme	termo
connu	conhecido
formation	formação
arts	artes
technique	técnica
révolution	revolução
etc	etc
objet	objeto
objet	objecto
mon	meu
philippe	filipe
question	pergunta
lorsque	quando
cinéma	cinema
plan	plano
van	van
médaille	medalha
serait	seria
œuvres	obras
zone	zona
zone	área
écrivain	escritor
compagnie	companhia
italien	italiano
championnats	campeonatos
laquelle	qual
films	filmes
surtout	sobretudo
surtout	principalmente
surtout	especialmente
sources	fontes
parc	parque
moyenne	média
mouvement	movimento
succès	sucesso
rivière	rio
jamais	nunca
vidéo	vídeo
martin	martin
claude	claude
claude	cláudio
superficie	superfície
moyen	médio
till	till
san	san
notre	nossa
notre	nosso
bon	bom
peintre	pintor
voix	vozes
voix	voz
rouge	vermelho
district	distrito
seulement	apenas
seulement	só
seulement	somente
pont	ponte
libre	livre
air	ar
air	air
sein	peito
sein	seio
milieu	meio
festival	festival
belgique	bélgica
grands	grandes
georges	jorge
blanc	branco
gauche	esquerda
travaux	trabalhos
donne	dá
passe	passa
produit	produto
diffusion	difusão
diffusion	divulgação
aide	ajuda
action	ação
andré	andré
font	font
réseau	rede
utilisé	usado
utilisé	utilizado
victoire	vitória
femmes	mulheres
minutes	minutos
aurait	teria
left	left
belge	belga
certaines	algumas
durée	duração
espèces	espécies
angleterre	inglaterra
afrique	áfrica
monuments	monumentos
sens	sentido
personne	pessoa
personne	ninguém
municipalité	município
frère	irmão
rencontre	encontro
trop	demais
trop	demasiado
japon	japão
publié	publicado
domaine	domínio
eux	eles
professeur	professor
particulier	especial
particulier	particular
quartier	bairro
color	color
scientifique	cientista
honneur	honra
seule	sozinha
cause	causa
rien	nada
nouvelles	notícias
iii	iii
administration	administração
comte	conde
suivante	seguinte
suivante	próxima
fort	forte
fort	fort
hockey	hóquei
moi	eu
différents	diferentes
rome	roma
possible	possível
dix	dez
dix	dix
taille	tamanho
sport	desporto
principal	principal
sujet	tópico
sujet	assunto
référence	referência
croix	cruz
élections	eleições
mettre	colocar
titres	títulos
enfin	finalmente
millions	milhões
noir	preto
joue	joga
joue	bochecha
londres	londres
agglomération	aglomeração
moment	momento
chapelle	capela
russe	russo
prince	príncipe
manière	maneira
malgré	apesar
activités	actividades
réalisateur	diretor
réalisateur	realizador
monument	monumento
sciences	ciências
radio	rádio
classe	classe
aucun	nenhum
droite	direita
lieux	locais
lieux	localizações
née	nascida
actuel	atual
espace	espaço
villes	cidades
fer	ferro
activité	atividade
commence	começa
organisation	organização
sélection	seleção
sélection	selecção
assez	bastante
participe	participa
institut	instituto
james	james
internationale	internacional
cadre	moldura
cadre	quadro
sept	sete
différentes	diferentes
lac	lago
fiche	ficha
affaires	negócios
télévision	televisão
duc	duque
personnage	personagem
précédent	anterior
précédent	precedente
évêque	bispo
richard	richard
richard	ricardo
adresse	endereço
php	php
william	william
thomas	thomas
ball	ball
résultats	resultados
hors	fora
problème	problema
finalement	finalmente
bonne	boa
nature	natureza
grandes	grandes
michael	michael
vol	voo
port	porto
premières	primeiras
premières	primeiros
donné	dado
donné	doado
discussion	discussão
dame	dama
épouse	esposa
axe	eixo
mesure	medida
mesure	medição
voie	via
prendre	tomar
important	importante
données	dados
lequel	qual
george	george
force	força
pologne	polónia
couleur	cor
collection	coleção
actrice	atriz
élu	eleito
régiment	regimento
station	estação
loire	loire
bande	fita
bande	banda
capitale	capital
côte	costa
façon	maneira
étape	passo
étape	etapa
créée	criada
créée	criado
combat	combate
footballeur	futebolista
forces	forças
royal	royal
aucune	nenhuma
russie	rússia
nicolas	nicolau
mètres	metros
mètres	medidores
possède	possui
presse	imprensa
construit	construído
tournoi	torneio
épisodes	episódios
passage	passagem
entrée	entrada
revue	revisão
revue	revista
jeunes	jovens
présence	presença
course	corrida
ceinture	cinto
meilleure	melhor
tableau	tabela
tableau	quadro
heures	horas
maître	mestre
services	serviços
marque	marca
single	single
intérieur	interior
appelé	chamado
olympique	olímpico
subdivision	subdivisão
bernard	bernardo
qualité	qualidade
langues	línguas
propre	limpo
chine	china
politiques	políticas
lettres	letras
patrimoine	património
com	com
évolution	evolução
tours	torres
tours	tours
obtient	obtém
compositeur	compositor
joueurs	jogadores
lyon	lyon
généralement	geralmente
von	von
amérique	américa
mal	mal
rock	rock
abbaye	abadia
nuit	noite
principalement	principalmente
prise	take
prise	tomada
bretagne	bretanha
avaient	tinham
clubs	clubes
générale	geral
met	met
vitesse	velocidade
scénario	cenário
chemin	caminho
réalisation	realização
centrale	central
statut	status
groupes	grupos
avis	aviso
éléments	elementos
salle	sala
carte	mapa
périhélie	periélio
sociale	social
travers	travers
valeur	valor
utilisation	uso
utilisation	utilização
allemande	alemã
palais	palácio
émission	emissão
composé	composto
situation	situação
droits	direitos
court	curto
vallée	vale
comité	comitê
anciens	antigos
rugby	rugby
basse	baixa
basse	baixo
pro	pro
pro	pró
occasion	ocasião
occasion	oportunidade
total	total
for	for
nationalité	nacionalidade
chambre	quarto
nouveaux	novos
savoir	saber
glace	gelo
originale	original
proche	próximo
mot	palavra
main	mão
huit	oito
voïvodie	voivodia
assemblée	assembleia
assemblée	assembléia
populaire	popular
critique	crítica
del	del
publication	publicação
dieu	deus
uni	uni
japonais	japonês
australie	austrália
catholique	católico
mission	missão
https	https
accord	acordo
campagne	campanha
rapidement	rapidamente
traduction	tradução
anne	ana
départ	partida
étude	estudo
montréal	montreal
programme	programa
bgcolor	bgcolor
importante	importante
choix	escolha
coup	golpe
enfant	criança
information	informação
mieux	melhor
maurice	maurício
défense	defesa
vice	vício
vice	vice
contrôle	controle
contrôle	controlo
noms	nomes
produits	produtos
internet	internet
label	rótulo
label	label
hiver	inverno
fondation	fundação
européenne	europeia
troupes	tropas
antoine	antónio
daniel	daniel
cœur	coração
îles	ilhas
pris	tomado
pris	apanhados
marine	marinha
bâtiment	edifício
peter	peter
juste	só
juste	apenas
fondé	fundado
der	der
vient	vem
seine	sena
amour	amor
faisant	fazendo
mont	monte
statistiques	estatísticas
science	ciência
personnages	personagens
bonjour	olá
marc	marcos
altitude	altitude
économique	econômico
unité	unidade
particulièrement	especialmente
lignes	linhas
traité	tratado
montre	relógio
idée	idéia
idée	ideia
éditeur	editor
littérature	literatura
attaque	ataque
records	records
records	recordes
principaux	principais
sol	sol
chaîne	cadeia
ouvrage	obra
fondée	fundada
actuellement	atualmente
pourrait	poderia
reçoit	recebe
fond	fundo
format	formato
mode	moda
mode	modo
original	original
espagnol	espanhol
producteur	produtor
artiste	artista
créer	criar
composition	composição
los	los
décide	decide
garde	guarda
votre	seu
votre	sua
sécurité	segurança
fédération	federação
quatrième	quarta
junior	júnior
junior	junior
police	polícia
comédie	comédia
albert	albert
bruxelles	bruxelas
empereur	imperador
infanterie	infantaria
ministère	ministério
chevalier	cavaleiro
armes	armas
livres	livros
principales	principais
personnalités	personalidades
unique	único
unique	unique
capitaine	capitão
large	large
guillaume	guilherme
tel	tal
commission	comissão
demandé	perguntado
divers	diversos
tels	tais
décision	decisão
actuelle	atual
classique	clássico
présent	presente
fit	fit
passé	passado
mandat	mandado
mandat	mandato
berlin	berlim
isbn	isbn
taux	taxa
surface	superfície
architecture	arquitetura
inscrit	inscrito
astéroïde	asteróide
transport	transporte
sort	sai
rené	rené
alexandre	alexandre
oui	sim
annonce	anúncio
pièce	peça
pratique	prática
pratique	prático
conseiller	conselheiro
conseiller	consultor
portail	portal
terrain	terreno
usage	uso
comprend	inclui
comprend	compreende
secrétaire	secretária
secrétaire	secretário
world	world
tennis	tênis
donner	donner
donner	doar
donner	dar
chose	coisa
pièces	peças
fonctions	funções
accès	acesso
informations	informações
marché	mercado
charge	carregar
charge	carga
alpes	alpes
sites	sites
basket	basquetebol
utiliser	utilizar
utiliser	usar
économie	economia
longueur	comprimento
légende	lenda
légende	legenda
pense	pensa
vingt	vinte
vingt	vingt
arrivée	chegada
conditions	condições
élection	eleição
protection	proteção
protection	protecção
scénariste	escritor
bibliothèque	biblioteca
commerce	comércio
influence	influência
énergie	energia
petits	pequenos
parties	partes
fiction	ficção
intérêt	interesse
structure	estrutura
laurent	laurent
laurent	lourenço
kilomètres	quilómetros
kilomètres	quilômetros
jeunesse	juventude
régions	regiões
majorité	maioria
passer	passar
enseignement	ensino
veut	quer
exposition	exposição
poids	peso
santé	saúde
heure	hora
feu	fogo
atteint	alcança
atteint	atingido
atteint	alcançado
profession	profissão
trouver	encontrar
voyage	viagem
voyage	viagens
supérieur	superior
logo	logótipo
logo	logotipo
gestion	gestão
permettant	permitindo
derniers	últimos
localité	localidade
arrière	retaguarda
arrière	traseiro
arrière	traseira
city	city
régime	dieta
black	black
henry	henry
autriche	áustria
résultat	resultado
couleurs	cores
comment	como
nations	nações
central	central
signe	sinal
apparaît	aparece
orchestre	orquestra
concours	concurso
concours	competições
moderne	moderna
moderne	moderno
longue	longa
longue	longo
termine	termina
liées	ligadas
liées	relacionadas
wikipedia	wikipédia
phase	fase
problèmes	problemas
journaliste	jornalista
record	record
record	recorde
célèbre	famosa
célèbre	famoso
doivent	devem
mariage	casamento
svg	svg
powiat	condado
architecte	arquiteto
message	mensagem
mêmes	mesmos
artistes	artistas
constitution	constituição
nos	nossas
nos	nossos
roger	roger
presque	quase
propose	propõe
esprit	espírito
esprit	mente
suivi	acompanhamento
suivi	monitoramento
moteur	motor
relations	relações
ouverture	abertura
alain	alain
élève	aluno
séries	séries
vienne	viena
galerie	galeria
peuple	povo
découvert	descoberto
parlement	parlamento
zip	zip
étudiant	estudante
maria	maria
techniques	técnicas
théorie	teoria
doute	duvida
doute	dúvida
suppression	remoção
suppression	supressão
mémoire	memória
ami	amigo
super	super
images	imagens
éducation	educação
magazine	revista
don	don
pourquoi	porquê
situe	situa
aller	ir
note	nota
hauteur	altura
morts	mortos
camp	acampamento
considéré	considerado
secteur	setor
probablement	provavelmente
social	social
représentant	representante
saisons	estações
temple	templo
forêt	floresta
importance	importância
maintenant	agora
forte	forte
conflit	conflito
commandant	comandante
meurt	morre
ben	ben
docteur	doutor
christian	christian
gouverneur	governador
artistique	artístico
loin	longe
collège	colégio
utilise	utiliza
utilise	usa
bassin	bacia
victoires	vitórias
rend	torna
bureau	escritório
contrat	contrato
féminin	feminino
romain	romano
professionnel	profissional
marseille	marselha
arbitre	árbitro
justice	justiça
directement	diretamente
appel	chamada
semaine	semana
pied	pé
chanteur	cantor
neuf	nove
européen	europeu
photographie	fotografia
principe	princípio
latin	latim
victor	victor
connue	conhecida
bord	borda
distribution	distribuição
environnement	ambiente
canadien	canadense
utilisée	usado
utilisée	usada
entreprises	empresas
lumière	luz
supérieure	superior
frères	irmãos
automobile	automóvel
train	trem
train	comboio
soviétique	soviético
soviétique	soviética
lieutenant	tenente
textes	textos
moitié	metade
pilote	piloto
josé	josé
studio	estúdio
réponse	resposta
reine	rainha
patrick	patrick
physique	física
auteurs	autores
chansons	canções
compris	percebido
compris	compreendido
étienne	estêvão
représente	representa
via	via
californie	califórnia
volume	volume
militaires	militares
pape	papa
questions	perguntas
parle	fala
courant	corrente
lire	ler
lire	leia
industrie	indústria
lettre	letra
lettre	carta
terres	terras
denis	denis
brésil	brasil
man	man
opération	operação
piste	trilha
piste	faixa
paix	paz
vieux	velho
propriétaire	proprietário
faible	fraco
faible	fraca
algérie	argélia
journée	dia
chargé	carregado
cathédrale	catedral
participation	participação
puissance	potência
zones	zonas
final	final
simon	simon
simon	simão
endémique	endémica
formule	fórmula
value	value
rendre	tornar
rendre	render
opéra	ópera
reçu	recebido
urbaine	urbana
joué	jogado
joué	jogou
derrière	atrás
piano	piano
gros	grande
montagne	montanha
diverses	diversas
diverses	várias
découverte	descoberta
red	red
beaux	lindos
front	frente
circonscription	equitação
poète	poeta
marcel	marcel
champ	campo
val	val
religieux	religioso
archives	arquivo
archives	arquivos
vote	votação
projets	projetos
formes	formas
lycée	liceu
proximité	proximidade
seront	serão
intitulé	intitulado
romaine	romana
alt	alt
obtenir	obter
blanche	branca
angeles	angeles
belle	linda
motif	motivo
continue	continua
chant	canto
chant	cantar
mondial	mundial
colonel	coronel
congrès	congresso
chinois	chinês
frédéric	frederico
soleil	sol
utilisateur	usuário
allemands	alemães
moscou	moscovo
amis	amigos
shift	shift
lnh	nhl
toulouse	toulouse
peinture	pintura
légion	legião
inclinaison	inclinação
figure	figura
mexique	méxico
limite	limite
dernières	últimas
cinquième	quinto
cinquième	quinta
gens	pessoas
guitare	guitarra
liberté	liberdade
html	html
contenu	conteúdo
star	star
fête	festa
rhône	ródano
photo	foto
canal	canal
vincent	vincent
jouer	jogar
jules	jules
précédente	anterior
aphélie	afélio
polonais	polonês
analyse	análise
noire	preta
noire	preto
recherches	pesquisa
côtés	lados
offre	oferta
sauf	excepto
sauf	exceto
sauf	salvo
travaille	trabalha
frontière	fronteira
max	max
américains	americanos
existence	existência
indépendance	independência
anciennes	antigas
eaux	águas
bâtiments	edifícios
love	love
uniquement	apenas
uniquement	somente
entière	inteira
résistance	resistência
mes	meus
dessous	abaixo
smith	smith
caractère	caráter
contient	contém
bleu	azul
asie	ásia
jack	jack
classé	arquivado
excentricité	excentricidade
www	www
guy	guy
signifie	significa
tome	tomo
objets	objectos
objets	objetos
sommet	cimeira
border	border
faits	fatos
construite	construída
construite	construído
matière	matéria
licence	licença
juifs	judeus
suit	segue
médecin	médico
écrire	escrever
lance	lance
fonds	fundo
besoin	necessidade
fondateur	fundador
avance	avanço
avance	adiantamento
grec	grego
bordeaux	bordeaux
règles	regras
soldats	soldados
mark	mark
chicago	chicago
provence	provença
publie	publica
religion	religião
successeur	sucessor
cimetière	cemitério
composée	composta
somme	soma
formé	formado
formé	treinado
éviter	evitar
réserve	reserva
défaite	derrota
sports	esportes
ceci	isto
background	background
maritime	marítimo
épreuve	experimentação
voies	vias
cardinal	cardeal
exploitation	exploração
sert	serve
encyclopédie	enciclopédia
résumé	resumo
lorraine	lorraine
lutte	luta
parents	pais
tournée	turnê
tournée	rodada
rose	rosa
disque	disco
recensement	censo
philosophie	filosofia
open	open
hôpital	hospital
propriété	propriedade
gentilé	gentílico
cycliste	ciclista
collaboration	colaboração
ouvert	aberto
parler	falar
expression	expressão
astéroïdes	asteroides
nécessaire	necessário
règne	reinado
suède	suécia
difficile	difícil
inconnu	desconhecido
tom	tom
champions	campeões
modèles	modelos
vit	vive
meilleurs	melhores
animaux	animais
cheval	cavalo
soutien	apoio
soutien	suporte
navires	navios
dispose	dispõe
débuts	estréia
milan	milão
animation	animação
raymond	raymond
méthode	método
communication	comunicação
petites	pequenas
commun	comum
jardin	jardim
min	min
avion	avião
paroisse	paróquia
internes	internos
mots	palavras
portugal	portugal
vert	verde
strasbourg	estrasburgo
personnel	pessoal
local	local
frank	frank
olivier	oliveira
catherine	catarina
historien	historiador
inde	índia
relation	relacionamento
crée	cria
navire	navio
baptiste	baptiste
étudiants	estudantes
apparition	aparição
apparition	aparecimento
manque	saudades
comptait	contava
plein	cheio
vont	vão
naturel	natural
opposition	oposição
franco	franco
simplement	simplesmente
essentiellement	essencialmente
adaptation	adaptação
abbé	abade
gérard	gérard
argument	argumento
semaines	semanas
familles	famílias
expérience	experiência
gardien	guardião
appelle	chama
dramatique	dramática
dramatique	dramático
extérieur	exterior
restauration	restauração
draft	draft
médecine	medicina
établissement	estabelecimento
marne	marne
régional	regional
thème	tema
prison	prisão
distance	distância
capacité	capacidade
littéraire	literário
écoles	escolas
arrêté	parado
tradition	tradição
réalité	realidade
savoie	saboia
connaissance	conhecimento
étoile	estrela
marche	caminhada
jaune	amarelo
serbie	sérvia
permettent	permitem
office	office
telle	tal
traitement	tratamento
masse	massa
arc	arco
tombe	cai
tombe	túmulo
concerne	concerne
risque	risco
socialiste	socialista
réalise	realiza
notables	notáveis
vrai	verdade
armées	exércitos
ton	teu
baseball	beisebol
arabe	árabe
acte	ato
arthur	arthur
arthur	artur
live	live
grèce	grécia
major	major
civile	civil
essai	teste
essai	ensaio
décrit	descreve
décrit	descrito
écosse	escócia
albums	álbuns
héros	herói
team	team
termes	termos
permis	licença
nantes	nantes
filles	meninas
midi	midi
pdf	pdf
géographique	geográfico
géographique	geográfica
ciel	céu
anti	anti
occidentale	ocidental
washington	washington
maladie	doença
aéroport	aeroporto
king	king
dictionnaire	dicionário
autorité	autoridade
portant	vestindo
with	with
édifice	edifício
préfecture	prefeitura
officielle	oficial
futur	futuro
objectif	objectivo
objectif	objetivo
cap	cabo
ingénieur	engenheiro
actes	atos
irlande	irlanda
occupe	ocupa
hongrie	hungria
peine	pena
britanniques	britânicos
absence	ausência
importants	importantes
guerres	guerras
yves	yves
chanteuse	cantora
crise	crise
brigade	brigada
chapitre	capítulo
laisse	deixa
madrid	madrid
cordialement	atenciosamente
drapeau	bandeira
utilisés	usados
application	aplicativo
application	aplicação
responsable	responsável
responsable	mantenedor
circuit	circuito
banque	banco
décédé	faleceu
décédé	falecido
danse	dança
désigner	designar
genève	genebra
développé	desenvolvido
systèmes	sistemas
élèves	alunos
officiellement	oficialmente
remplacé	substituído
fleuve	rio
univers	universo
villages	vilas
critiques	críticas
vraiment	realmente
american	american
argentine	argentina
salon	salão
écriture	escrita
libération	libertação
entièrement	inteiramente
entièrement	totalmente
places	lugares
largement	extensamente
largement	amplamente
die	die
jazz	jazz
caractéristiques	características
réunion	reunião
trente	trinta
julien	juliano
chasse	caça
administrative	administrativa
processus	processo
comporte	comporta
gaz	gás
orléans	orleães
catégories	categorias
park	park
propres	limpos
press	press
united	united
mixte	misto
régulièrement	regularmente
juan	juan
véritable	verdadeiro
véritable	verdadeira
lee	lee
rapide	rápido
agriculture	agricultura
traduit	traduzido
chœur	coro
décret	decreto
léon	leão
naturelle	natural
plantes	plantas
permettre	permitir
nommée	nomeada
résidence	residência
fusion	fusão
critères	critérios
commandement	comando
portrait	retrato
mairie	prefeitura
choses	coisas
jan	jan
sang	sangue
jeanne	joana
indique	indica
yeux	olhos
all	all
types	tipos
moyens	meios
évolue	evolui
prédécesseur	antecessor
retraite	aposentadoria
description	descrição
table	tabela
table	mesa
antonio	antónio
antonio	antonio
magnitude	magnitude
blue	blue
emploi	emprego
promotion	promoção
québécois	quebequense
alliance	aliança
dite	dita
obtenu	obtido
unités	unidades
quel	qual
importantes	importantes
brun	marrom
brun	castanho
originaire	originário
faite	feita
participé	participado
participé	participou
actions	acções
actions	ações
baron	barão
contributeurs	contribuintes
biographie	biografia
effets	efeitos
bosnie	bósnia
explique	explica
égypte	egito
avenue	avenida
blocage	bloqueio
dominique	dominique
nœud	nó
serbe	sérvio
serbe	sérvia
événements	eventos
christophe	christophe
atelier	workshop
atelier	oficina
auguste	augusto
raisons	razões
devrait	deveria
devrait	deve
francis	francis
atlantique	atlântico
bout	ponta
faisait	fazia
cent	cem
voiture	carro
agent	agente
disney	disney
écrite	escrita
chute	queda
communiste	comunista
présentation	apresentação
trouvent	encontram
étranger	estrangeiro
documentaire	documentário
cartes	mapa
sièges	assentos
secret	segredo
couple	casal
col	colo
col	col
métro	metro
mary	mary
mines	minas
conférence	conferência
alsace	alsácia
mains	mãos
alfred	alfred
locaux	locais
publiée	publicado
publiée	publicada
soir	noite
coureur	corredor
basé	baseado
différence	diferença
bateau	barco
musicale	musical
enregistré	gravado
enregistré	registrado
enregistré	registado
xls	xls
connexe	relacionado
changement	mudança
députés	deputados
commencé	começou
commencé	começado
électrique	elétrico
électrique	elétrica
telles	tais
opérations	operações
vite	rápido
diocèse	diocese
rhin	reno
identité	identidade
normandie	normandia
culturel	cultural
variation	variação
romans	romances
bourg	bourg
rejoindre	aderir
hommage	homenagem
collecte	recolha
collecte	coleta
faveur	favor
transports	transportes
seuls	sozinhos
juge	juiz
néerlandais	holandês
lille	lille
complexe	complexo
und	und
concept	conceito
titulaire	titular
contexte	contexto
contact	contato
fortement	altamente
fortement	fortemente
vis	parafuso
vis	parafusos
concert	concerto
lois	leis
douze	doze
ferme	fazenda
ferme	quinta
one	one
correspond	corresponde
hautes	altas
édouard	eduardo
massif	maciço
vente	venda
athlétisme	atletismo
culte	culto
répartition	repartição
répartition	distribuição
matériel	material
avocat	advogado
bras	braço
calais	calais
proposition	proposta
conduit	conduz
perdu	perdido
nice	nice
visite	visita
solution	solução
atteindre	alcançar
volley	voleibol
promu	promovido
portes	portas
informatique	computadores
informatique	informática
conception	projeto
conception	design
mur	parede
scientifiques	cientistas
tourisme	turismo
passant	passando
suivants	seguintes
green	green
luc	lucas
façade	fachada
statue	estátua
photos	fotos
construire	construir
tente	tenda
scott	scott
liège	cortiça
utilisant	usando
huile	óleo
convention	convenção
orient	oriente
tourné	virou
dessin	desenho
barcelone	barcelona
manuel	manuel
joe	joe
pression	pressão
maroc	marrocos
faux	falso
constitué	constituído
christ	cristo
colombie	colômbia
baie	baía
documents	documentos
athlète	atleta
bourgogne	borgonha
contraire	contrário
destination	destino
champs	campos
vierge	virgem
lesquels	quais
température	temperatura
enfance	infância
acteurs	atores
candidat	candidato
lancé	lançado
dates	datas
procès	julgamento
tenant	segurando
cercle	círculo
essais	ensaios
aider	ajudar
mention	menção
arrêt	parada
agence	agência
perd	perde
mari	marido
mari	mari
élément	elemento
pouvait	podia
représentation	representação
cycle	ciclo
chemins	caminhos
renaissance	renascimento
pouvant	podendo
hall	hall
hall	salão
attention	cuidado
attention	atenção
jones	jones
marin	marin
domaines	domínios
usine	fábrica
fontaine	fonte
fontaine	fontaine
parlementaire	parlamentar
roland	roland
printemps	primavera
prêtre	sacerdote
étoiles	estrelas
réforme	reforma
chris	chris
gabriel	gabriel
élevé	alto
élevé	elevado
xixe	xix
monastère	mosteiro
organisé	organizado
dos	costas
noël	natal
enquête	inquérito
trouvé	encontrado
anomalie	anomalia
ign	ign
beau	lindo
villa	villa
lecture	leitura
montage	montagem
dollars	dólares
professionnelle	profissional
masculin	masculino
cantons	cantões
branche	ramo
batterie	bateria
pointe	ponta
thèse	tese
rgb	rgb
démocratique	democrática
démocratique	democrático
géographie	geografia
nancy	nancy
amateur	amadora
amateur	amador
ascendant	ascendente
assurer	assegurar
sait	sabe
caroline	carolina
participer	participar
autorités	autoridades
clair	clair
test	teste
west	west
relativement	relativamente
découvre	descobre
exemplaires	exemplares
exemplaires	cópias
versions	versões
venir	vir
laisser	deixar
gilles	gilles
plateau	tabuleiro
bataillon	batalhão
vin	vinho
découvreur	descobridor
spécialiste	especialista
vivant	vivo
ressources	recursos
ajouter	adicionar
féminine	feminina
régionale	regional
rencontres	namoro
demander	perguntar
israël	israel
tué	assassinado
tué	morto
généraux	generais
siècles	séculos
présenté	apresentado
territoires	territórios
png	png
mike	mike
revanche	vingança
recueil	colectânea
napoléon	napoleão
net	net
planète	planeta
endroit	lugar
bilan	balanço
intervention	intervenção
auparavant	anteriormente
législature	legislatura
bob	bob
white	white
océan	oceano
idées	idéias
combats	lutas
corée	coreia
tokyo	tóquio
totale	total
finales	finais
bus	autocarro
bus	ônibus
certaine	certa
comprendre	compreender
vivre	viver
edward	edward
ordres	ordens
arme	arma
dynastie	dinastia
erreur	erro
publications	publicações
déroule	desenrola
coll	coll
organisme	organismo
williams	williams
faculté	faculdade
génération	geração
expédition	expedição
tchèque	checo
google	google
européens	europeus
arbre	árvore
tribunal	tribunal
appartient	pertence
règle	regra
règle	régua
walter	walter
possibilité	possibilidade
euros	euros
eugène	eugène
avions	aviões
archevêque	arcebispo
participants	participantes
dvd	dvd
artillerie	artilharia
mesures	medidas
occupation	ocupação
vent	vento
logiciel	software
définition	definição
danemark	dinamarca
administrateur	administrador
vos	suas
vos	seus
bruno	bruno
travailler	trabalhar
églises	igrejas
mouvements	movimentos
mouvements	movimento
former	treinar
former	formar
princesse	princesa
volonté	vontade
germain	germain
oiseaux	aves
homonymie	desambiguação
race	raça
disponible	disponível
totalement	totalmente
continentale	continental
ski	esqui
ouvre	abre
échelle	escala
machine	máquina
sujets	tópicos
change	câmbio
change	muda
change	change
luxembourg	luxemburgo
antique	antigo
manche	manga
monte	monte
canadienne	canadense
buteur	artilheiro
dimanche	domingo
électronique	eletrônica
fil	fio
suivre	siga
suivre	seguir
sixième	sexto
sixième	sexta
accident	acidente
cérémonie	cerimónia
cérémonie	cerimônia
discours	discurso
bill	bill
finaliste	finalista
humaine	humana
échange	troca
nationales	nacionais
riche	rico
riche	rica
complète	completa
néo	neo
langage	linguagem
effectif	efetivo
feuilles	folhas
maréchal	marechal
répondre	responder
herzégovine	herzegovina
spectacle	espetáculo
spectacle	show
plans	planos
moulin	moinho
déclare	declara
débat	debate
numérique	digital
rendu	renderização
musicien	músico
champagne	champanhe
disparu	desaparecido
biens	bens
poésie	poesia
ouverte	aberta
ouverte	aberto
choisi	seleto
choisi	escolhido
valeurs	valores
accueil	acolhimento
accueil	home
accueil	recepção
tar	tar
productions	produções
fédéral	federal
big	big
montagnes	montanhas
louise	luísa
supprimer	apagar
supprimer	remover
aventure	aventura
harry	harry
consacré	dedicado
claire	claire
proches	próximos
dirigé	dirigido
carlos	carlos
guide	guia
solid	solid
anna	anna
jésus	jesus
adjoint	adjunto
steve	steve
initialement	inicialmente
actif	ativo
événement	evento
installe	instala
fonctionnement	funcionamento
rennes	rennes
exception	exceção
extrême	extrema
extrême	extremo
populations	populações
contributions	contribuições
venise	veneza
associé	sócio
associé	associado
civil	civil
connaître	conhecer
tunisie	tunísia
group	group
élus	eleitos
lancer	lançar
lancer	lançamento
tiers	terceiros
tiers	terceiro
commande	comando
porté	portado
interprète	intérprete
tony	tony
standard	padrão
standard	standard
réalisée	realizada
médias	mídia
introduction	introdução
porter	porter
approche	abordagem
approche	aproximação
reconnaissance	reconhecimento
metal	metal
boston	boston
liés	relacionados
liés	ligados
effectue	realiza
effectue	efetua
eric	eric
provinces	províncias
pose	pose
orange	laranja
adam	adão
fleurs	flores
matin	manhã
missions	missões
flotte	frota
dessins	desenhos
monsieur	senhor
côtes	costelas
chefs	chefs
amateurs	amadores
turquie	turquia
localisation	localização
gagne	vence
gagne	ganha
officiers	oficiais
origines	origens
indépendant	independente
blason	brasão
écrits	escritos
house	house
importe	importa
marquis	marquês
pouvoirs	poderes
commercial	comercial
bat	bat
césar	césar
suédois	sueco
young	young
victimes	vítimas
mille	milha
direct	direct
direct	direto
dames	damas
siren	siren
couronne	coroa
attaquant	atacante
mini	mini
privé	privado
réaliser	realizar
appareil	aparelho
considère	considera
commons	commons
diffusé	difundido
outils	ferramentas
complet	completo
florence	florença
trophée	troféu
finlande	finlândia
paroles	letras
aspect	aspecto
envoyé	enviado
tôt	cedo
rares	raros
rares	raras
comportement	comportamento
contributeur	contribuinte
humain	humano
signé	assinado
texas	texas
russes	russos
septième	sétima
septième	sétimo
sélections	seleções
pascal	pascal
internationales	internacionais
maillot	camisa
dispute	disputa
lune	lua
orbite	órbita
championne	campeã
développer	desenvolver
interieur	interior
extension	extensão
scènes	cenas
amiral	almirante
murs	paredes
francs	francos
modifications	alterações
modifications	modificações
norvège	noruega
college	college
life	life
corse	córsega
mario	mário
mario	mario
prises	tomadas
initiative	iniciativa
autonome	autônomo
marguerite	margarida
datant	namoro
datant	datando
mathématiques	matemática
brown	brown
améliorer	melhorar
sénateur	senador
solo	solo
montpellier	montpellier
morte	morta
cherche	procura
serge	sérgio
rouen	rouen
profondeur	profundidade
partage	partilha
partage	compartilhamento
apprend	aprende
changer	mudar
croissance	crescimento
interne	interna
interne	interno
portugais	português
stations	estações
profil	perfil
refuse	recusa
hans	hans
maximum	máximo
cabinet	gabinete
cabinet	consultório
toi	tu
thierry	thierry
saône	saône
présidence	presidência
voyageurs	viajantes
sculpteur	escultor
alexander	alexander
vision	visão
miss	miss
metz	metz
forêts	florestas
étapes	etapas
étapes	passos
céleste	celeste
associations	associações
grade	grau
impériale	imperial
sam	sam
contenant	contendo
modifier	editar
poursuit	prossegue
dehors	fora
servir	servir
protéger	proteger
baisse	baixa
pacifique	pacífico
madame	senhora
madame	madame
grecque	grego
fédérale	federal
sébastien	sebastian
défenseur	defensor
œil	olho
diplôme	diploma
lié	vinculado
lié	ligado
récit	narrativa
réaction	reação
cyclisme	ciclismo
fabrication	fabricação
nucléaire	nuclear
karl	karl
chevaux	cavalos
climat	clima
instrument	instrumento
respectivement	respectivamente
respectivement	respetivamente
automne	outono
caractères	caracteres
secondaire	secundário
trains	comboios
grenoble	grenoble
animal	animal
roumanie	roménia
appelés	chamados
victime	vítima
semi	semi
reconnu	reconhecido
rues	ruas
véhicules	veículos
garonne	garonne
interprétation	interpretação
proposé	propôs
proposé	proposto
papier	papel
gray	gray
emmanuel	emmanuel
plante	planta
repris	retomado
boulevard	boulevard
interdit	proibido
entier	inteiro
london	london
angle	ângulo
contemporain	contemporâneo
contemporain	contemporânea
preuve	prova
barrage	barragem
immédiatement	imediatamente
anvers	antuérpia
giovanni	giovanni
courses	corridas
sable	areia
présents	presentes
toronto	toronto
courte	curta
domicile	domicílio
aime	ama
aime	amo
routes	estradas
orientale	oriental
impose	impõe
impose	imponha
programmes	programas
placé	colocado
flore	flora
budget	orçamento
noblesse	nobreza
policier	polícia
toile	teia
inspiré	inspirado
chercher	procurar
évaluation	avaliação
classification	classificação
détruit	destruído
quartiers	bairros
liaison	ligação
principes	princípios
disparition	desaparecimento
bistro	bistro
échec	falha
échec	fracasso
rédaction	redação
serveur	servidor
liée	ligada
hausse	subida
oise	oise
signature	assinatura
trône	trono
prennent	tomam
carl	carl
produire	produzindo
produire	produzir
profit	lucro
chien	cão
chien	cachorro
urss	urss
correspondant	correspondente
time	time
zélande	zelândia
traverse	atravessa
nationaux	nacionais
marqué	marcado
secondes	segundos
requête	petição
studios	estúdios
ruisseau	córrego
roche	rocha
connus	conhecidos
largeur	largura
remplacer	substituir
org	org
françoise	francisca
spécial	especial
foi	fé
professionnels	profissionais
récemment	recentemente
munich	munique
institutions	instituições
vii	vii
établissements	estabelecimentos
pêche	pesca
complètement	completamente
volumes	volumes
nation	nação
développe	desenvolve
accueille	acolhe
notion	noção
symbole	símbolo
alger	argel
catalogue	catálogo
prisonniers	prisioneiros
francophone	francófona
tir	tiro
puits	poço
salles	salas
emplacement	localização
unies	unidas
philosophe	filósofo
étudie	estuda
facilement	facilmente
benoît	bento
décidé	decidido
souhaite	deseja
end	end
étage	andar
coups	batidas
forment	formam
johnson	johnson
hongrois	húngaro
rois	reis
modification	modificação
modification	alteração
pieds	pés
pensée	pensamento
phénomène	fenômeno
bel	bel
utilisées	utilizadas
utilisées	usadas
planètes	planetas
engage	compromete
vaste	vasto
relais	relé
déposé	depositado
roy	roy
exemples	exemplos
établir	estabelecer
nomme	nomeia
marins	marinheiros
poèmes	poemas
tendance	tendência
libéral	liberal
orientation	orientação
post	post
xxx	xxx
congo	congo
street	street
ennemi	inimigo
moselle	moselle
moselle	mosela
multiples	múltiplos
multiples	múltipla
multiples	múltiplas
retourne	retorna
indien	índio
indien	indiano
comptes	contas
joueuse	jogadora
calendrier	calendário
clocher	campanário
avenir	futuro
mécanique	mecânica
jérusalem	jerusalém
étrangers	estrangeiros
réel	real
cavalerie	cavalaria
écran	tela
écran	ecrã
concerts	concertos
organise	organiza
jim	jim
industriel	industrial
rester	permanecer
rester	ficar
consommation	consumo
mauvais	ruim
mauvais	mau
brian	brian
condition	condição
utilisateurs	utilizadores
utilisateurs	usuários
plaine	planície
perte	perda
aires	aires
intégral	integral
méthodes	métodos
impact	impacto
candidats	candidatos
victoria	victoria
lesquelles	quais
classes	classes
attaques	ataques
portée	alcance
quitter	sair
quitter	deixar
performance	desempenho
oscar	oscar
définitivement	definitivamente
romains	romanos
établi	estabelecido
basée	baseada
collectif	coletivo
compétitions	competições
quantité	quantidade
conseillers	conselheiros
versailles	versailles
anniversaire	aniversário
conservateur	conservador
destiné	destinado
niveaux	níveis
alex	alex
noter	anotar
capable	capaz
communautés	comunidades
estime	estima
internationaux	internacionais
effectivement	efetivamente
couverture	cobertura
couverture	capa
cuisine	cozinha
arbres	árvores
émissions	emissões
disposition	disposição
racing	racing
conservatoire	conservatório
parallèle	paralelo
sénat	senado
humains	humanos
donnant	dando
ray	ray
milliards	biliões
milliards	bilhões
huitième	oitava
huitième	oitavo
pos	pos
bertrand	bertrand
blues	blues
modernes	modernas
xxie	xxi
entrer	entrar
réseaux	redes
réseaux	rede
édité	editado
duché	ducado
alliés	aliados
hauts	altos
tentative	tentativa
progressivement	progressivamente
progressivement	gradualmente
dragon	dragão
mène	lidera
canons	canhões
canons	canhão
vandalisme	vandalismo
difficultés	dificuldades
penser	pensar
tableaux	quadros
personnelle	pessoal
présenter	apresentar
affirme	afirma
vaisseau	nave
autrefois	outrora
autrefois	antigamente
café	café
cher	cher
cher	caro
inscription	inscrição
isabelle	isabel
confiance	confiança
propriétés	propriedades
polonaise	polonesa
aix	aix
aventures	aventuras
instruments	instrumentos
conserve	conserva
départements	departamentos
finances	finanças
galles	gales
onze	onze
moteurs	motores
allant	indo
pratiques	práticas
prévu	previsto
procédure	procedimento
charente	charente
pleine	plena
noirs	negros
noirs	pretos
célèbres	famosos
dimensions	dimensões
pertes	perdas
ajoute	adiciona
ajoute	acrescenta
laval	laval
ontario	ontário
document	documento
augmentation	aumento
limites	limites
qualification	qualificação
éric	eric
condamné	condenado
ernest	ernest
oncle	tio
conservé	conservado
génie	gênio
voitures	carros
contemporaine	contemporânea
jackson	jackson
blancs	brancos
best	best
démocrate	democratas
démocrate	democrata
plage	praia
drame	drama
entretien	manutenção
entretien	entrevista
vide	vazio
musiciens	músicos
accepte	aceita
saints	santos
show	show
félix	félix
revenir	voltar
handball	handebol
benjamin	benjamin
reims	reims
windows	windows
canon	canhão
collections	coleções
anthony	anthony
active	ativa
organisée	organizada
organisée	organizado
initiale	inicial
ali	ali
décors	cenários
sculpture	escultura
chance	chance
chance	sorte
attendre	esperar
destruction	destruição
samuel	samuel
dir	dir
cross	cross
real	real
avignon	avignon
amsterdam	amesterdão
sophie	sophie
sophie	sofia
auvergne	auvergne
enregistrement	gravação
enregistrement	registo
davis	davis
quotidien	diário
quotidien	diária
leader	leader
leader	líder
trafic	tráfego
auto	auto
spécifique	específico
peau	pele
ferdinand	fernando
duo	dueto
duo	duo
espaces	espaços
impossible	impossível
ukraine	ucrânia
maine	maine
vieille	velha
incendie	incêndio
acide	ácido
gilbert	gilbert
auraient	teriam
poule	galinha
succession	sucessão
kevin	kevin
technologie	tecnologia
kim	kim
madeleine	madeleine
intègre	integra
utile	útil
saut	salto
pré	pré
enceinte	grávida
conservation	conservação
pouvez	pode
hugo	hugo
sacré	sagrado
régulière	regular
sortir	sair
centres	centros
affluent	afluente
ministres	ministros
stephen	stephen
sociaux	sociais
clairement	claramente
athènes	atenas
urbain	urbano
xiii	xiii
clermont	clermont
préfet	prefeito
essentiel	essencial
assure	assegura
stéphane	stéphane
laboratoire	laboratório
distingue	distingue
primaire	primário
restent	permanecem
portent	carregam
wiki	wiki
équipage	tripulação
tuer	matar
logique	lógica
adapté	adaptado
xavier	xavier
orgue	órgão
bulletin	boletim
impression	impressão
dépend	depende
conséquence	conseqüência
conséquence	consequência
visible	visível
habitat	habitat
breton	bretão
souris	rato
souris	mouse
photographe	fotógrafo
autoroute	autoestrada
ponts	pontes
taylor	taylor
vérité	verdade
quinze	quinze
mérite	merece
mérite	mérito
constituée	constituída
jérôme	jerome
assistant	assistente
bavière	baviera
marié	casado
satellite	satélite
samedi	sábado
alan	alan
chili	chile
exécution	execução
carlo	carlo
établit	estabelece
boîte	caixa
rôles	papéis
légèrement	levemente
légèrement	ligeiramente
gallimard	gallimard
alice	alice
las	las
saxe	saxônia
comprenant	compreendendo
comprenant	including
intermédiaire	intermediário
distinctions	distinções
remarque	observação
thèmes	temas
installation	instalação
rapports	relatórios
circulation	circulação
australien	australiano
chinoise	chinês
relief	relevo
pierres	pedras
universitaires	acadêmicos
histoires	histórias
faites	faça
pdd	pd
équivalent	equivalente
phrase	frase
récompense	recompensa
lancement	lançamento
patron	patrão
patron	chefe
conçu	projetado
structures	estruturas
culturelle	cultural
aviation	aviação
journaux	jornais
chrétiens	cristãos
syndicat	sindicato
lewis	lewis
menace	ameaça
poursuite	perseguição
basque	basco
mans	mans
lot	lote
débit	débito
commissaire	comissário
araignées	aranhas
employé	empregado
parole	palavra
manifestations	manifestações
installé	instalado
arabes	árabes
conserver	conservar
conserver	manter
reprendre	retomar
manga	manga
manga	mangá
conseils	dicas
latine	latim
bases	bases
andrew	andrew
diamètre	diâmetro
peintures	pinturas
invasion	invasão
adversaire	adversário
conduite	condução
seraient	seriam
individus	indivíduos
franchise	franquia
iran	irã
blessés	feridos
conscience	consciência
maîtres	mestres
représenté	representado
expositions	exposições
rappelle	recorda
naples	nápoles
lion	leão
peur	medo
prague	praga
administratif	administrativo
lausanne	lausanne
peuples	povos
nomination	nomeação
crime	crime
chrétienne	cristã
little	little
respect	respeito
mobile	móvel
mobile	celular
chiffres	números
british	british
sœurs	irmãs
vendredi	sexta
spéciale	especial
commentaire	comentário
véhicule	veículo
départemental	departamental
della	della
irlandais	irlandês
densité	densidade
catholiques	católicos
apparaissent	aparecem
rare	raros
transfert	transferência
laissé	deixado
blessé	ferido
annoncé	anunciado
aile	asa
carré	quadrado
dimension	dimensão
juive	judaica
var	var
lit	cama
floride	flórida
fera	fará
servi	servido
situés	localizados
seuil	limiar
milliers	milhares
loup	lobo
détroit	estreito
mémoires	memórias
préparation	preparação
chronologie	cronologia
classiques	clássico
classiques	clássicos
minimum	mínimo
révolutionnaire	revolucionário
nécessaires	necessários
nécessaires	necessárias
bibliographie	bibliografia
grave	grave
lord	lorde
tourne	vira
faute	falta
brunswick	brunswick
infobox	infobox
million	milhão
poème	poema
extrait	extrato
contribution	contribuição
hill	hill
rivières	rios
directe	direta
directe	direto
inférieure	inferior
gris	cinzento
gris	cinza
aquitaine	aquitânia
clément	clément
barbara	bárbara
barbara	barbara
euro	euro
léger	ligeiro
léger	leve
disponibles	disponíveis
danger	perigo
land	land
désigné	designado
utilisent	usam
wilson	wilson
libres	livres
plate	plana
similaire	semelhante
similaire	similar
travaillé	trabalhou
municipalités	municípios
viennent	vêm
cordes	cordas
golden	golden
détail	detalhe
dan	dan
accompagné	acompanhado
hypothèse	hipótese
matériaux	materiais
risques	riscos
confluence	confluência
charlotte	charlotte
jury	júri
anglo	anglo
révolte	revolta
monnaie	moeda
monnaie	troco
enseigne	ensina
enseigne	alferes
renommée	fama
franc	franco
révèle	revela
didier	didier
mac	mac
variété	variedade
ascension	ascensão
vendu	vendido
dirigeants	líderes
ford	ford
jane	jane
frontières	fronteira
frontières	fronteiras
observatoire	observatório
ailes	asas
machines	máquinas
julie	julie
institution	instituição
donna	donna
caen	caen
organisations	organizações
varsovie	varsóvia
déclaré	declarado
présidentielle	presidencial
compter	contar
south	south
normale	normal
résolution	resolução
pilotes	drivers
conquête	conquista
rowspan	rowspan
colonie	colônia
hélène	helena
besoins	necessidades
genres	gêneros
bref	breve
inférieur	inferior
tenir	segurar
cannes	cannes
neige	neve
postes	posts
discussions	discussões
installer	instalar
défaut	defeito
discipline	disciplina
responsabilité	responsabilidade
paysage	paisagem
suffit	basta
succède	sucede
poissons	peixes
couvent	convento
violence	violência
coût	custo
bains	banhos
espoirs	esperanças
comics	comics
comics	quadrinhos
africain	africano
bandes	fitas
trouvait	encontrava
sir	sir
cellules	células
cellules	célula
fosse	fossa
costumes	fatos
johnny	johnny
précisément	precisamente
espoir	esperança
actuels	atuais
jardins	jardins
destinée	destino
médailles	medalhas
angers	angers
détails	detalhes
déclaration	declaração
extrémité	extremidade
extrémité	ponta
colonne	coluna
populaires	popular
populaires	populares
dirigée	dirigida
dirigée	dirigido
monaco	mônaco
mises	apostas
fêtes	festas
gagner	ganhar
dijon	dijon
invité	convidado
affiche	cartaz
affiche	exibe
outil	ferramenta
orientales	orientais
prêt	empréstimo
publiés	publicados
mauvaise	ruim
mauvaise	má
inventaire	inventário
violon	violino
effectué	efetuado
élevée	elevada
élevage	pecuária
traditionnelle	tradicional
remplacement	substituição
islam	islamismo
battu	espancado
battu	batido
envoie	manda
envoie	envia
réduit	reduzida
réduit	reduzido
traces	vestígios
war	war
égalité	igualdade
créateur	criador
expliquer	explicar
environs	arredores
juridique	jurídica
juridique	jurídico
coalition	coligação
coalition	coalizão
intérêts	juros
fox	fox
inspecteur	inspector
inspecteur	inspetor
due	devida
marais	pântano
moines	monges
kong	kong
chimie	química
prenant	tomando
poisson	peixe
inter	inter
fruits	fruta
passion	paixão
start	start
présentent	apresentam
chercheurs	investigadores
chercheurs	pesquisadores
chat	gata
stratégie	estratégia
johann	johann
semblent	parecem
sarah	sarah
interprété	interpretado
retrait	retirada
coopération	cooperação
laissant	deixando
archipel	arquipélago
relève	releva
compagnies	companhias
géorgie	geórgia
âme	alma
gothique	gótico
bloc	bloco
méditerranée	mediterrâneo
visiteurs	visitantes
clan	clã
répond	responde
capital	capital
caractérisée	caracterizada
surnom	apelido
surnom	alcunha
express	expresso
naît	nasce
électricité	eletricidade
électricité	electricidade
mit	mit
facile	fácil
différent	diferente
découvrir	descobrir
changements	mudanças
fred	fred
chrétien	cristão
oxford	oxford
croatie	croácia
ange	anjo
chasseurs	caçadores
gaston	gaston
robin	robin
opinion	opinião
bonnes	boas
classements	classificações
classements	rankings
récompenses	recompensas
xiv	xiv
conflits	conflitos
transformation	transformação
remplace	substitui
cultures	culturas
étudier	estudar
consacrée	consagrada
lundi	segunda
viii	viii
limitée	limitado
limitée	limitada
andrea	andrea
accessible	acessível
universités	universidades
virginie	virgínia
avantage	vantagem
appui	sustentação
appui	apoio
engagé	comprometido
engagé	contratado
objectifs	objetivos
ann	ann
écossais	escocês
métier	profissão
soirée	noite
mélange	mistura
mine	mina
donnent	dão
montée	subida
alphonse	afonso
state	state
acquis	conquistas
acquis	adquirida
lucien	lucien
disques	discos
représentent	representem
représentent	representam
support	suporte
sydney	sydney
qualifié	qualificado
introduit	introduziu
introduit	introduzido
introduit	introduz
caractéristique	característica
belles	lindas
nba	nba
howard	howard
charlie	charlie
guitariste	guitarrista
évêques	bispos
défendre	defender
conséquences	consequências
maires	prefeitos
elizabeth	elizabeth
recevoir	receber
performances	desempenho
autrichien	austríaco
brest	brest
pianiste	pianista
étrangère	estrangeira
friedrich	friedrich
occupé	ocupado
archéologique	arqueologia
musées	museus
traversée	travessia
armand	armand
antiquité	antiguidade
brésilien	brasileiro
produite	produzida
produite	produzido
doctorat	doutorado
centaines	centenas
maîtrise	mestrado
encyclopédique	enciclopédico
réédition	reedição
calcul	cálculo
rêve	sonho
mathieu	mateus
camille	camille
dérivés	derivados
aspects	aspetos
aspects	aspectos
simples	simples
plaque	placa
fondateurs	fundadores
ffffff	ffffff
body	body
nez	nariz
quai	cais
démocratie	democracia
meurtre	assassinato
meurtre	homicídio
barre	barra
meilleures	melhores
métropole	metrópole
vigueur	vigor
neuvième	nono
minute	minuto
élite	elite
applications	aplicações
aîné	sênior
verre	vidro
équipement	equipamento
abandon	abandono
abandon	desistência
queue	cauda
ivoire	marfim
hong	hong
ivan	ivan
design	design
pistes	pistas
exécutif	executivo
jonathan	jonathan
jacob	jacob
jacob	jacó
mythologie	mitologia
belgrade	belgrado
revenu	renda
guinée	guiné
gamme	gama
basilique	basílica
girl	girl
confédération	confederação
dessinateur	desenhista
jimmy	jimmy
arrêter	parar
regard	olhar
rallye	rali
valence	valência
amitié	amizade
colspan	colspan
dossier	pasta
diego	diego
maladies	doenças
oiseau	pássaro
ump	ump
verte	verde
citer	citar
constructeur	construtor
péninsule	península
francesco	francesco
campagnes	campanhas
compilation	compilação
connaissances	conhecimento
copié	copiado
budapest	budapeste
représentations	representações
noble	nobre
ambassadeur	embaixador
inverse	inverso
inverse	inversa
opérateur	operador
possession	posse
possession	possessão
souvenir	memória
souvenir	lembrança
forteresse	fortaleza
ennemis	inimigos
sections	secções
sections	seções
viens	vem
positions	posições
engagement	compromisso
languedoc	languedoc
inscrits	registrados
inscrits	inscritos
quarante	quarenta
hectares	hectares
golfe	golfo
italiens	italianos
title	title
situées	situadas
supprimé	excluído
supprimé	removido
douglas	douglas
lady	lady
listes	listas
boy	boy
arbitrage	arbitragem
lecteur	leitor
idem	idem
remise	desconto
établie	estabelecida
tire	puxa
hop	hop
christopher	christopher
maintenir	manter
réduire	reduzir
anderson	anderson
christine	cristina
christine	christine
goût	sabor
morceaux	pedaços
sélectionné	seleccionado
sélectionné	selecionado
venus	venus
miller	miller
dédié	dedicado
exil	exílio
terminé	concluído
terminé	terminado
cambridge	cambridge
construits	construídos
fixe	fixo
sncf	sncf
ventes	vendas
relative	relativa
instruction	instrução
cancer	câncer
donald	donald
agents	agentes
observation	observação
parallèlement	paralelamente
fréquence	frequência
dure	dura
scrutin	votação
scrutin	escrutínio
sortant	saindo
vins	vinhos
employés	empregados
out	out
forum	fórum
lanceur	lançador
administrativement	administrativamente
solaire	solar
alimentation	alimentação
neutre	neutro
tués	mortos
orthodoxe	ortodoxa
citoyens	cidadãos
vladimir	vladimir
ouvriers	trabalhadores
pseudonyme	alcunha
humanité	humanidade
clé	chave
manuscrit	manuscrito
déterminer	determinar
défaites	derrotas
colline	colina
who	who
divisions	divisões
dédiée	dedicada
dédiée	dedicado
gustave	gustave
longues	longas
longues	longos
régionales	regionais
continent	continente
naturelles	naturais
trésor	tesouro
ruines	ruínas
technologies	tecnologia
technologies	tecnologias
fais	faz
existent	existem
existent	existam
picardie	picardia
porto	porto
bourbon	bourbon
difficulté	dificuldade
désignations	designações
franz	franz
ombre	sombra
cousin	primo
équipements	equipamentos
vapeur	vapor
interview	entrevista
bay	bay
colonnes	colunas
pôle	polo
républicain	republicano
attribué	atribuído
choisit	escolhe
rédacteur	editor
stanley	stanley
muet	mudo
historiens	historiadores
garçon	rapaz
garçon	menino
western	western
vérifier	verificar
proposer	propor
transmission	transmissão
soldat	soldado
veille	véspera
présentée	apresentada
canadiens	canadenses
jersey	jersey
sénégal	senegal
option	opção
pluie	chuva
commentaires	comentários
fpu	fpu
turin	turim
poitou	poitou
touche	tecla
évoque	evoca
automatique	automático
automatique	automática
compétences	competências
extrêmement	extremamente
neveu	sobrinho
pictures	pictures
mohamed	mohamed
hubert	hubert
cinquante	cinquenta
cinquante	cinqüenta
éventuellement	possivelmente
éventuellement	eventualmente
publicité	publicidade
souverain	soberano
associés	sócios
associés	associados
chargée	carregada
chargée	carregado
chronique	crônica
chronique	crónica
charte	carta
imposer	impor
renault	renault
préface	prefácio
échecs	xadrez
frais	frescos
frais	fresco
figures	figuras
traite	ordenha
pérou	peru
bac	bandeja
bloqué	bloqueado
judiciaire	judiciário
palette	paleta
indépendante	independente
tramway	eléctrico
peintres	pintores
élisabeth	isabel
amiens	amiens
louvre	louvre
troubles	perturbações
marco	marco
lès	lès
entertainment	entertainment
offensive	ofensiva
amie	amiga
alias	alias
concentration	concentração
intention	intenção
series	series
nombres	números
précision	precisão
passagers	passageiros
can	can
degré	grau
puissant	poderosa
puissant	poderoso
espagnols	espanhóis
départementale	departamental
correspondance	correspondência
hamilton	hamilton
partiellement	parcialmente
tim	tim
organismes	organismos
sauver	salvar
juniors	juniores
visage	cara
visage	rosto
possibles	possíveis
country	country
provoque	provoca
future	futuro
future	futura
danois	dinamarquês
montrer	mostrar
conférences	conferências
paramètres	configurações
réflexion	reflexão
philadelphie	filadélfia
that	that
prononciation	pronúncia
actualité	notícia
aube	aube
aube	amanhecer
mariée	casada
meuse	meuse
billy	billy
répertoire	diretório
entraîne	treina
écrivains	escritores
admissibilité	elegibilidade
poser	posar
mazovie	mazóvia
traditionnel	tradicional
lacs	lagos
suprême	supremo
suprême	suprema
musulmans	muçulmanos
ain	ain
autorisation	autorização
sexe	sexo
séjour	estada
séjour	estadia
installations	instalações
andy	andy
suivent	seguem
travailleurs	trabalhadores
norme	norma
appareils	aparelhos
gordon	gordon
ordinateur	computador
graphique	gráfico
repose	descansa
ligues	ligas
nick	nick
surprise	surpresa
juif	judeu
efficace	eficiente
efficace	eficaz
bulgarie	bulgária
grecs	gregos
séparation	separação
perdre	perder
puy	puy
contes	contos
longs	comprido
longs	longos
votes	votações
votes	votos
tibet	tibete
spectateurs	espectadores
supplémentaires	adicionais
stars	estrelas
stars	stars
parfaitement	perfeitamente
favorable	favorável
baroque	barroco
milieux	meios
secteurs	setores
secteurs	sectores
pavillon	pavilhão
will	will
tournois	torneios
gagné	ganho
gagné	ganhei
gagné	ganhou
retirer	remover
ateliers	oficinas
accueillir	acolher
distinction	distinção
xviiie	xviii
den	den
four	forno
garder	guardar
garder	manter
venezuela	venezuela
your	your
triple	tripla
triple	triplo
eure	eure
vécu	vivido
high	high
autel	altar
manoir	mansão
continuer	continuar
fournir	fornecer
propriétaires	proprietários
efforts	esforços
créés	criados
roussillon	roussillon
influencé	influenciado
treize	treze
exclusivement	exclusivamente
plat	prato
reconstruction	reconstrução
columbia	columbia
bons	bons
choisir	escolher
administrateurs	administradores
rarement	raramente
reliant	ligando
spécialisée	especializada
global	global
bruce	bruce
beach	beach
consensus	consenso
troupe	tropa
sauvage	selvagem
consulté	consultado
clip	clip
clip	clipe
optique	óptica
fantastique	fantástico
accéder	acessar
occidental	ocidental
navigation	navegação
augmenter	aumentar
synthèse	síntese
pourraient	poderiam
voyages	viagens
phare	farol
surveillance	vigilância
surveillance	monitorização
initial	inicial
story	story
déplacement	deslocamento
différente	diferente
francophones	francófonos
prieuré	priorado
revenus	rendimentos
désert	deserto
naturels	naturais
ibn	ibn
nam	nam
enseignant	docente
enseignant	professor
enseignant	ensinando
signes	sinais
bourse	bolsa
territoriale	territorial
dépôt	depósito
exactement	exatamente
marquée	marcada
hollywood	hollywood
tunis	tunes
presses	prensas
prusse	prússia
théologie	teologia
laura	laura
intérieure	interior
sun	sun
augustin	agostinho
augustin	augustin
peint	pintado
peint	pinta
froid	frio
réputation	reputação
not	not
syrie	síria
flandre	flandres
villeneuve	villeneuve
fréquemment	freqüentemente
alexis	alexis
lublin	lublin
playstation	playstation
ronde	redonda
ronde	rodada
allen	allen
colonies	colônias
responsables	responsáveis
riches	ricos
pékin	pequim
apparence	aparência
couche	camada
fortune	fortuna
changé	mudado
changé	mudou
châteaux	castelos
animateur	apresentador
animateur	animador
master	master
mathématicien	matemático
autonomie	autonomia
expansion	expansão
particuliers	particulares
partielle	parcial
dragons	dragões
formations	formações
numéros	números
besançon	besançon
giuseppe	giuseppe
malheureusement	infelizmente
provisoire	provisório
classés	classificados
veuve	viúva
apporter	trazer
nicole	nicole
programmation	programação
cameroun	camarões
soins	cuidados
linguistique	linguística
exercice	exercício
héritier	herdeiro
lah	lah
bot	bot
fonctionne	funciona
botanique	botânica
connues	conhecidas
amoureux	apaixonado
amélioration	melhoramento
amélioration	melhoria
successivement	sucessivamente
manchester	manchester
vivent	vivem
spécifiques	específicos
spécifiques	específicas
vouloir	querer
virus	vírus
iso	iso
fermeture	fechamento
participent	participam
poursuivre	perseguir
poursuivre	prosseguir
voile	vela
aisne	aisne
monarchie	monarquia
spécialisé	especializado
spécialisé	especializada
soutenu	suportado
soutenu	apoiado
décisions	decisões
marchand	comerciante
remarquable	notável
yougoslavie	jugoslávia
universelle	universal
hugues	hugo
zurich	zurique
assassinat	assassinato
restaurant	restaurante
first	first
abandonné	abandonado
fernando	fernando
wilhelm	wilhelm
franche	franca
tribu	tribo
hebdomadaire	semanal
belges	belgas
rotation	rotação
apporte	traz
tiré	puxado
composés	compostos
attitude	atitude
transféré	transferido
jugement	julgamento
bible	bíblia
cyrillique	cirílico
clark	clark
rayon	raio
civils	civis
nécessité	necessidade
limoges	limoges
têtes	cabeças
immeuble	edifício
métal	metal
space	space
vocation	vocação
facteur	fator
rangers	rangers
ryan	ryan
épée	espada
commencent	começam
salut	oi
banlieue	subúrbio
banlieue	subúrbios
protégée	protegida
appartenait	pertencia
courts	curto
courts	curtos
toulon	toulon
pic	pico
pic	pic
voisins	vizinhos
inconnue	desconhecida
fantasy	fantasy
fantasy	fantasia
jouant	jogando
devoir	dever
servant	servindo
opposé	oposto
bleue	azul
lake	lake
irak	iraque
bruges	bruges
progrès	progresso
métiers	ofícios
this	this
soixante	sessenta
tonnes	toneladas
poche	bolso
dieux	deuses
producteurs	produtores
copie	cópia
intégré	integrado
jason	jason
surnommé	apelidado
chimique	química
carbone	carbono
modifié	modificado
mâle	macho
ouvrir	abrir
pétrole	petróleo
normal	normal
illinois	illinois
attaché	adido
attaché	amarrado
confirme	confirma
corporation	corporation
corporation	corporação
gras	gordura
gras	negrito
hervé	hervé
médiévale	medieval
cible	alvo
possèdent	possuem
africaine	africana
africaine	africano
extra	extra
dark	dark
morceau	pedaço
évoluant	evoluindo
dixième	décima
dixième	décimo
pyramide	pirâmide
pasteur	pastor
nintendo	nintendo
apprentissage	aprendizagem
adopté	adoptado
adopté	adotado
entraînement	treino
kelly	kelly
arnaud	arnaud
actifs	ativos
volontaires	voluntários
arrête	pára
filiale	subsidiária
filiale	filial
plaisir	prazer
limousin	limousin
époux	marido
époux	cônjuge
organiser	organizar
bateaux	barcos
lisa	lisa
soutient	suporta
soutient	apoia
soutient	apóia
individuel	individual
anime	anime
croire	acreditar
présentant	apresentando
domination	dominação
débats	debates
moto	moto
tunnel	túnel
échapper	escapar
fenêtres	janelas
mineur	menor
vertical	vertical
équilibre	equilíbrio
empêche	impede
variable	variável
sanctuaire	santuário
illustrations	ilustrações
erreurs	erros
bis	bis
slovaquie	eslováquia
statistique	estatística
paramètre	parâmetro
psychologie	psicologia
constantinople	constantinopla
fouilles	escavação
fouilles	escavações
diplômé	graduado
sel	sal
princes	príncipes
découvertes	descobertas
examen	revisão
examen	exame
héritage	herança
recours	recurso
hitler	hitler
commencer	começar
lancée	lançada
madagascar	madagáscar
combattants	combatentes
combattants	lutadores
candidature	candidatura
théorème	teorema
darkgrey	darkgrey
tracé	traçado
expériences	experiências
concurrence	concorrência
étudié	estudado
jeff	jeff
buenos	buenos
massacre	massacre
potentiel	potencial
annuel	anual
voisin	vizinho
représenter	representar
free	free
fortes	fortes
dialogue	diálogo
évidemment	obviamente
annuelle	anual
thérèse	teresa
grotte	caverna
pain	pão
décident	decidem
toit	telhado
opus	opus
suivie	seguido
suivie	seguida
individu	indivíduo
russell	russell
death	death
dits	ditos
réduction	redução
alberto	alberto
tension	tensão
chaînes	correntes
soviétiques	soviéticos
soumis	submetido
secrets	segredos
intégration	integração
wimbledon	wimbledon
rythme	ritmo
intervient	intervém
arriver	chegar
voulait	queria
écart	desvio
montré	mostrado
rupture	ruptura
vague	onda
décor	decoração
signal	sinal
placée	colocada
poitiers	poitiers
otto	otto
steven	steven
suicide	suicídio
accords	acordos
margaret	margaret
refus	recusa
périodes	períodos
mentionné	mencionado
mentionné	mencionada
hollande	holanda
box	box
indiquer	indicar
song	song
crédit	crédito
xvi	xvi
librairie	livraria
audio	áudio
vosges	vosges
fuite	fuga
dôme	cúpula
associée	associada
associée	sócia
reproduction	reprodução
christianisme	cristianismo
parcs	parques
entendu	ouvido
signifiant	significando
dispositif	dispositivo
pouvaient	podiam
habitant	habitante
acier	aço
réélu	reeleito
traditions	tradições
formant	formando
générique	genéricos
générique	genérico
civilisation	civilização
occuper	ocupar
silence	silêncio
admis	admitidos
admis	admitido
verts	verdes
détruite	destruído
détruite	destruída
isère	isère
raoul	raoul
définit	define
publier	publicar
arguments	argumentos
contribue	contribui
lait	leite
parisien	parisiense
matt	matt
antenne	antena
charbon	carvão
léopold	leopoldo
maxi	maxi
archéologie	arqueologia
agir	agir
financement	financiamento
uefa	uefa
soutenir	apoiar
traducteur	tradutor
ambassade	embaixada
miami	miami
propositions	propostas
men	men
dur	duro
dénomination	denominação
dénomination	nome
constante	constante
inclus	incluído
inclus	incluídos
two	two
fruit	fruta
montant	montante
jouent	jogam
journalistes	jornalistas
légère	ligeiro
légère	ligeira
légère	leve
incluant	incluindo
miguel	miguel
marbre	mármore
agissait	agia
sicile	sicília
trait	traço
clients	clientes
souvenirs	lembranças
souvenirs	memórias
étendue	extensão
bad	bad
insectes	insetos
prisonnier	prisioneiro
edmond	edmond
répartis	repartidos
interdiction	proibição
montrent	mostram
transition	transição
durable	sustentável
durable	sustentabilidade
mar	mar
intelligence	inteligência
précédents	precedentes
photographies	fotografias
payer	pagar
formée	formado
formée	formada
libéré	libertado
libéré	liberado
chaleur	calor
catalogne	catalunha
blog	blog
square	square
ingénieurs	engenheiros
indonésie	indonésia
variétés	variedades
urgence	urgência
urgence	emergência
qualifie	qualifica
passent	passam
loisirs	lazer
lambert	lambert
liquide	líquido
capacités	capacidades
gary	gary
officiels	oficiais
présidents	presidentes
femelle	fêmea
étages	andares
power	power
écliptique	eclíptica
beauté	beleza
indépendants	independentes
achat	compra
marques	marcas
boulogne	boulogne
réponses	respostas
admin	admin
gallo	gallo
solutions	soluções
inauguré	inaugurado
gaulle	gaulle
rev	rev
apparaître	aparecer
traiter	tratar
graves	graves
cuba	cuba
testament	testamento
attaquer	atacar
prévue	planejada
contribuer	contribuir
seize	dezesseis
old	old
great	great
décoration	decoração
fermé	fechado
développée	desenvolvido
développée	desenvolvida
times	times
voient	veem
alphabet	alfabeto
jordan	jordan
supplémentaire	extra
schéma	esquema
contribué	contribuiu
contribué	contribuído
campus	campus
représentée	representada
pie	pie
pie	pio
dis	diz
vues	vistas
vues	visualizações
solide	sólidos
solide	sólido
philip	philip
fiat	fiat
charges	cargas
bureaux	escritórios
atmosphère	atmosfera
réelle	real
ajout	adição
réception	recepção
dave	dave
mourir	morrer
financier	financeiro
personnelles	pessoais
retire	retira
nelson	nelson
témoin	testemunha
conte	conto
règlement	regulamento
shorts	shorts
horreur	horror
manifeste	manifesto
pirates	piratas
fenêtre	janela
occident	ocidente
reich	reich
assaut	assalto
délégation	delegação
acquisition	aquisição
inclut	inclui
évènements	eventos
défini	definido
clés	chaves
certainement	certamente
revues	revisões
system	system
morale	moral
préfère	prefere
placer	colocar
nobel	nobel
adultes	adultos
spectacles	shows
voisine	vizinha
emblème	emblema
alternative	alternativa
littéralement	literalmente
trace	trace
ours	urso
portraits	retratos
wild	wild
limité	limitado
limité	limitada
chevaliers	cavaleiros
bla	blá
bla	bla
loir	loir
normes	normas
électriques	elétricos
pauvres	pobres
refuge	refúgio
nourriture	comida
nourriture	alimento
participant	participante
facteurs	fatores
balle	bala
dynamique	dinâmica
partenaire	parceira
partenaire	parceiro
ross	ross
boris	boris
branches	ramos
démission	demissão
aragon	aragão
batailles	batalhas
assassiné	assassinado
alpin	alpino
illustré	ilustrado
colin	colin
management	gerência
consulter	consultar
zéro	zero
atp	atp
gironde	gironda
intéressant	interessante
remix	remix
fra	fra
identique	idêntica
identique	idêntico
clôture	fechamento
clôture	encerramento
cheveux	cabelo
varie	varia
fournit	fornece
traités	tratados
respecter	respeitar
apparemment	aparentemente
bbc	bbc
trio	trio
communistes	comunistas
lourd	pesado
sérieux	seriedade
sérieux	sério
obligatoire	obrigatório
obligatoire	obrigatória
dordogne	dordonha
fermée	fechado
moore	moore
reconnue	reconhecida
explosion	explosão
honoré	honrado
exerce	exerce
augmente	aumenta
existait	existia
esclaves	escravos
médecins	médicos
nathalie	nathalie
quentin	quentin
désir	desejo
grégoire	gregório
culturels	culturais
sec	sec
sec	seco
divisé	dividido
indice	índice
comtesse	condessa
paysans	camponeses
complexes	complexos
noyau	núcleo
germanique	germânica
mené	conduzido
remarquer	notar
flux	fluxo
courants	correntes
forts	fortes
ohio	ohio
motifs	motivos
lisbonne	lisboa
évidence	evidência
fleur	flor
dizaines	dezenas
séance	sessão
turc	turco
charentes	charentes
increment	increment
réserves	reservas
tirer	puxar
navarre	navarra
hambourg	hamburgo
envoyer	enviar
morgan	morgan
définir	definir
oblast	oblast
micro	micro
micro	microfone
oriental	oriental
géant	gigante
consul	cônsul
lourdes	lourdes
logiciels	software
paradis	paraíso
ian	ian
marqués	marcados
anjou	anjou
entendre	ouvir
tempête	tempestade
abréviations	abreviaturas
constantin	constantino
embouchure	foz
bonheur	felicidade
moine	monge
arm	arm
négociations	negociações
oliver	oliver
bâle	basileia
congrégation	congregação
conclusion	conclusão
band	band
nîmes	nîmes
franck	franck
stockholm	estocolmo
accent	acento
accent	sotaque
efficacité	eficiência
efficacité	eficácia
cuivre	cobre
concile	concílio
cents	cêntimos
cents	centavos
ferrari	ferrari
apostolique	apostólica
grosse	gordinha
viande	carne
indiqué	indicado
communications	comunicações
romancier	romancista
probable	provável
ken	ken
escalier	escada
diable	diabo
argentin	argentino
récupérer	recuperar
herbert	herbert
berne	berna
roberto	roberto
chante	canta
jerry	jerry
talent	talento
invités	convidados
town	town
natation	natação
apprendre	aprender
sols	solos
détruire	destruir
ardenne	ardenas
castille	castela
movie	movie
client	cliente
syndrome	síndrome
restes	restos
prêtres	padres
alcool	álcool
elena	elena
passages	passagens
centaine	centena
inspiration	inspiração
retiré	removido
sombre	escuro
lourds	pesado
lourds	pesados
habituellement	geralmente
habituellement	normalmente
vainqueurs	vencedores
nécessite	exige
nécessite	requer
coordonnées	coordenadas
dead	dead
allait	ia
racine	raiz
fidèle	fiel
lecteurs	leitores
roux	ruivo
illustration	ilustração
intégrer	integrar
rapporte	rende
rapporte	relata
écologie	ecologia
forcément	forçosamente
spécialistes	especialistas
ajouté	adicionado
ultime	derradeiro
ultime	derradeira
pseudo	apelido
constructions	construções
accompagne	acompanha
variations	variações
descente	descida
remplacée	substituída
magasin	loja
landes	landes
landes	charneca
punk	punk
sucre	açúcar
rendent	tornam
manifestation	manifestação
installée	instalada
installée	instalado
gold	gold
cite	cite
symphonie	sinfonia
vêtements	roupas
vêtements	roupa
vêtements	vestuário
dance	dance
adulte	adulto
explication	explicação
différences	diferenças
biographique	biográfico
vendus	vendidos
trad	trad
considérer	considerar
variante	variante
redirection	redirecionamento
tomber	cair
roches	rochas
stone	stone
entité	entidade
bottom	bottom
duchesse	duquesa
play	play
abraham	abraão
couvert	coberto
précédemment	anteriormente
délégué	delegado
cahiers	cadernos
phases	fases
tribus	tribos
vraie	verdadeira
astronome	astrónomo
graveur	gravador
contemporains	contemporâneo
contemporains	contemporânea
régionaux	regionais
wikimedia	wikimedia
battant	batendo
carter	carter
francfort	frankfurt
flèche	seta
#ffffff	#ffffff
circonscriptions	circunscrições
experts	peritos
experts	especialistas
attentat	atentado
arles	arles
colorado	colorado
feuille	folha
difficiles	difíceis
coupes	cortes
douce	doce
remarquables	notáveis
dep	dep
michigan	michigan
descendants	descendentes
khan	khan
indre	indre
finlandais	finlândia
finlandais	finlandês
intervenir	intervir
case	case
enfer	inferno
districts	distritos
inutile	inútil
inutile	desnecessário
déchets	resíduos
comique	comédia
bell	bell
bénéficie	beneficia
doté	dotado
manuscrits	manuscritos
atlanta	atlanta
essence	gasolina
essence	essência
séminaire	seminário
provenance	proveniência
vancouver	vancouver
orthographe	ortografia
lucas	lucas
biologie	biologia
massachusetts	massachusetts
essayer	tentar
marchés	mercados
cellule	célula
fou	louco
accepter	aceitar
heinrich	heinrich
coréen	coreano
courage	coragem
moulins	moinhos
humour	humor
banques	bancos
nommés	nomeados
battre	bater
clavier	teclado
norvégien	norueguês
cologne	colônia
cologne	colónia
positif	positivo
minnesota	minnesota
compléter	completar
plume	caneta
singles	singles
paysages	paisagens
barry	barry
kansas	kansas
garros	garros
dissolution	dissolução
grève	greve
marchandises	mercadorias
prévoit	prevê
qualités	qualidades
fichiers	arquivos
fichiers	ficheiros
patrice	patrice
pratiquement	praticamente
disparue	sumida
disparue	desaparecida
quatorze	quatorze
quatorze	catorze
visibles	visíveis
arménie	armênia
norman	norman
tirant	puxando
allier	allier
xviie	xvii
leipzig	leipzig
dites	digam
dites	diga
possédait	possuía
fernand	fernand
bonaparte	bonaparte
promouvoir	promover
observations	observações
rural	rural
codes	códigos
warner	warner
récente	recente
malade	doente
arena	arena
imprimerie	tipografia
évaluer	avaliar
réduite	reduzida
perspective	perspectiva
garçons	rapazes
garçons	meninos
edgar	edgar
doctrine	doutrina
walt	walt
militant	ativista
militant	militante
tourner	girar
tourner	virar
impérial	imperial
sultan	sultão
abandonne	desiste
liban	líbano
calédonie	caledônia
hermann	hermann
sociologie	sociologia
messages	mensagens
ballet	ballet
ballet	balé
accusé	acusado
onu	onu
ernst	ernst
effort	esforço
affecté	afetado
stuart	stuart
implique	envolve
index	índice
veulent	querem
téléphone	telefone
documentation	documentação
enregistre	grava
bouche	boca
queen	queen
hiérarchie	hierarquia
lyonnais	lyonnais
blessure	lesão
blessure	ferimento
blessure	ferida
équateur	equador
fine	fine
bourgeois	burguês
statues	estátuas
anneau	anel
chambres	quartos
youtube	youtube
issues	edições
xii	xii
sporting	sporting
pire	pior
profite	curtindo
profite	aproveita
onde	onda
retourner	voltar
financiers	financeiros
abc	abc
exposé	exposto
définie	definida
masque	máscara
combattre	combater
ouvrier	operário
gloire	glória
basses	baixas
archive	arquivo
protégé	protegido
tâche	tarefa
monter	montar
monter	subir
fidèles	fiéis
causes	causas
papillon	borboleta
comparaison	comparação
panneaux	painéis
préparer	preparar
vendée	vendeia
illustre	ilustre
automatiquement	automaticamente
accepté	aceite
accepté	aceito
pousse	cresce
pousse	empurra
luigi	luigi
grant	grant
globe	globo
procureur	procurador
ardennes	ardenas
atlas	atlas
caisse	caixa
génétique	genética
ballon	balão
endroits	lugares
choc	choque
ondes	ondas
gérer	gerir
gérer	gerenciar
romantique	romântico
frappe	bate
partant	partindo
philippines	filipinas
quotidienne	diária
islamique	islâmica
entouré	cercado
anonyme	anónima
applique	aplica
applique	aplique
assurance	seguros
assurance	seguro
audience	audiência
phil	phil
helsinki	helsínquia
lawrence	lawrence
unesco	unesco
comportant	comportando
littoral	litoral
danny	danny
module	módulo
enterré	enterrado
bonus	bônus
bonus	bónus
théories	teorias
hot	hot
éliminatoires	eliminatórias
restera	permanecerá
disant	dizendo
uci	uci
diversité	diversidade
rocher	rocha
garnison	guarnição
résoudre	resolvendo
résoudre	resolver
résistant	resistente
islande	islândia
macédoine	macedónia
sculptures	esculturas
investissement	investimento
absolument	absolutamente
incident	incidente
are	are
chêne	carvalho
transformé	transformado
transformé	transformada
concerto	concerto
adversaires	adversários
privés	privados
boys	boys
compagnon	companheiro
chroniques	crônicas
tue	mata
paolo	paolo
radical	radical
partenariat	parceria
entrées	entradas
stratégique	estratégico
stratégique	estratégica
réfugiés	refugiados
berger	pastor
cache	cache
égale	igual
œufs	ovos
tentatives	tentativas
particularité	particularidade
emma	emma
blanches	brancas
miles	miles
demandes	pedidos
distinguer	distinguir
réalisées	realizadas
boxe	boxe
pair	par
industriels	industriais
tarn	tarn
compagnons	companheiros
challenge	challenge
challenge	desafio
adolphe	adolfo
serpent	serpente
chimiques	químicos
jeudi	quinta
livret	caderneta
média	mídia
noires	pretas
georg	georg
individuelle	individual
parker	parker
tes	teus
métropolitaine	metropolitana
isaac	isaac
traits	traços
foyer	foco
comtes	condes
invite	convida
anges	anjos
rencontrer	conhecer
étang	lagoa
virginia	virgínia
virginia	virginia
restant	permanecendo
restant	restante
rassemble	reúne
symboles	símbolos
vols	voos
voûte	abóbada
murray	murray
méridionale	meridional
racines	raízes
houston	houston
accueilli	hospedado
équipé	equipado
feux	luzes
parfait	perfeito
roumain	romeno
affluents	afluentes
mali	mali
repos	descanso
gardes	guardas
gand	gand
romane	românica
vents	ventos
rap	rap
circulaire	circular
vive	viva
fribourg	friburgo
décennies	décadas
assistance	assistência
assistance	suporte
uruguay	uruguai
esthétique	estética
servent	servem
suzanne	suzanne
coloniale	colonial
adams	adams
permanente	permanente
wayne	wayne
malte	malta
spider	spider
ahmed	ahmed
anton	anton
spéciaux	especiais
citation	citação
loiret	loiret
républicains	republicanos
indiens	índios
appliquer	aplicar
traditionnellement	tradicionalmente
âges	idade
âges	idades
offrir	oferecer
gridcolor	gridcolor
crédité	creditado
tests	testes
neutralité	neutralidade
sépare	separa
bière	cerveja
arr	arr
faibles	fracos
chelem	slam
arnold	arnold
élue	eleita
julia	júlia
industries	indústrias
destin	destino
books	books
angel	angel
précédentes	precedentes
précédentes	anteriores
archéologiques	arqueológicos
invention	invenção
ottawa	ottawa
podium	pódio
professeurs	professores
emplois	emprego
emplois	empregos
occupée	ocupada
confusion	confusão
paroisses	paróquias
clergé	clero
spécialement	especialmente
mosquée	mesquita
personnellement	pessoalmente
étrange	estranho
crimes	crimes
éteint	desligado
nobles	nobreza
nobles	nobres
exprimer	expressar
vendre	vender
vendre	venda
maintenance	manutenção
vicomte	visconde
session	sessão
marshall	marshall
sorbonne	sorbonne
lang	lang
vallées	vales
inc	inc
just	just
project	project
suites	suites
alentours	arredores
inauguration	inauguração
contrôler	controlar
pietro	pietro
colons	colonos
japan	japan
ferrand	ferrand
brésilienne	brasileira
arsenal	arsenal
adrien	adriano
larry	larry
majoritairement	maioritariamente
spéciales	especiais
récentes	recentes
armement	armamento
exprime	exprime
off	off
mayenne	mayenne
marion	marion
regroupant	agrupando
robe	vestido
golf	golfe
baker	baker
normalement	normalmente
jay	jay
mystère	mistério
stewart	stewart
phénomènes	fenômenos
similaires	similares
similaires	semelhantes
sage	sage
sage	sábio
vaisseaux	naves
béton	concreto
lions	leões
lions	lions
idéal	ideal
lionel	lionel
good	good
particules	partículas
écurie	estábulo
baby	baby
soprano	soprano
kennedy	kennedy
harris	harris
shakespeare	shakespeare
masters	masters
refusé	recusado
refusé	negado
coureurs	corredores
extraits	trechos
extraits	excertos
cadet	cadete
élevait	criava
triomphe	triunfo
tribune	tribune
reconnaît	reconhece
expose	expõe
hip	hip
lightgrey	lightgrey
coule	flui
down	down
pau	pau
mineurs	mineiros
mineurs	menores
dei	dei
commis	cometidos
commis	cometido
round	round
faciliter	facilitar
aval	jusante
montrant	mostrando
physicien	físico
immense	enorme
bobby	bobby
opposant	oponente
dangereux	perigoso
modes	modos
utilité	utilidade
fief	feudo
adoption	adoção
lignée	linhagem
robinson	robinson
usines	fábricas
panneau	painel
figurent	figuram
pomme	maçã
media	media
inscriptions	inscrições
messieurs	cavalheiros
messieurs	senhores
nil	nilo
rosa	rosa
bologne	bolonha
seed	seed
justification	justificação
spatial	espacial
saga	saga
salvador	salvador
party	party
reconnaître	reconhecer
principauté	principado
volant	volante
volant	voando
textcolor	textcolor
créant	criando
dents	dentes
may	may
tommy	tommy
richesse	riqueza
acquiert	adquire
ports	portos
indes	índia
terry	terry
mardi	terça
sprint	sprint
exploration	exploração
travaillant	trabalhando
matthew	matthew
cerveau	cérebro
fabrique	manufatura
fabrique	fabrica
voter	votar
diplomate	diplomata
relatif	relativo
relatif	relacionado
journées	dias
sommets	cimeiras
dramaturge	dramaturgo
urbaines	urbanas
centrales	centrais
écologique	ecológico
joan	joan
collaborateur	colaborador
profondément	profundamente
sentiment	sentimento
théodore	teodoro
architectes	arquitetos
transformer	transformar
médical	médicos
publiées	publicadas
habitude	hábito
modeste	modesta
modeste	modesto
interface	interface
fantôme	fantasma
animé	animado
ludwig	ludwig
dérivé	derivado
marcus	marcus
ottoman	otomano
conservée	conservada
imaginaire	imaginário
microsoft	microsoft
lens	lens
bucarest	bucareste
inscrite	inscrita
interventions	intervenções
témoignage	testemunho
arizona	arizona
nuls	nulos
décrite	descrito
décrite	descrita
satellites	satélites
satellites	satélite
mâles	machos
circonstances	circunstâncias
chancelier	chanceler
gratte	arranha
désignation	designação
heart	heart
déclin	declínio
thermique	térmico
venait	vinha
énorme	enorme
réformes	reformas
pôles	pólos
partenaires	parceiros
tombeau	túmulo
bruit	ruído
tchécoslovaquie	checoslováquia
devise	moeda
universel	universal
finir	acabar
finir	terminar
annie	annie
mercredi	quarta
limiter	limitar
sons	sons
circuits	circuitos
mono	mono
clinique	clínica
pennsylvanie	pensilvânia
accorde	concede
équation	equação
tenté	tentado
gouvernements	governos
cirque	circo
dépit	despeito
eddie	eddie
progression	progressão
cooper	cooper
intégrée	integrado
intégrée	integrada
vichy	vichy
tendances	tendências
dick	dick
remplaçant	substituto
urbanisme	urbanismo
électeurs	eleitores
simone	simone
thompson	thompson
variantes	variantes
aéronautique	aeronáutica
rochelle	rochelle
aigle	águia
salariés	assalariados
namur	namur
suspension	suspensão
royaumes	reinos
pen	pen
gravure	gravação
gravure	gravura
corriger	corrigir
rangs	fileiras
prière	oração
dallas	dallas
xvie	xvi
admins	admins
nationalités	nacionalidades
colonisation	colonização
women	women
pablo	pablo
appeler	chamar
appeler	ligar
religions	religiões
religions	religião
officielles	oficiais
volontaire	voluntário
lloyd	lloyd
affronter	enfrentar
chaud	quente
year	year
fans	fãs
aus	aus
adjectifs	adjectivos
socks	socks
attraction	atração
poètes	poetas
tri	tri
tri	ordenação
abandonner	desistir
colère	raiva
dépasse	ultrapassa
réactions	reacções
réactions	reações
symbolique	simbólica
symbolique	simbólico
symbolique	simbolismo
louvain	lovaina
transforme	transforma
patricia	patrícia
patricia	patricia
races	raças
way	way
renaud	reinaldo
news	notícias
león	león
armé	armado
graham	graham
digital	digital
sensible	sensível
compositions	composições
walker	walker
participa	participou
vertu	virtude
rhénanie	renânia
planches	tábuas
divisée	dividida
messe	missa
french	portuguese
french	french
jugé	julgado
jennifer	jennifer
obligation	obrigação
abri	abrigo
considérable	considerável
franklin	franklin
palestine	palestina
chiens	cães
collabore	colabora
species	species
rédigé	redigido
foule	multidão
suppose	supõe
bryan	bryan
impliquant	implicando
impliquant	envolvendo
registre	registro
registre	registo
extraction	extração
extraction	extracção
berry	berry
froide	fria
kurt	kurt
eva	eva
préciser	especificar
mécanisme	mecanismo
angoulême	angoulême
ensembles	conjuntos
mentionne	menciona
séville	sevilha
ébauche	esboço
geneviève	genevieve
bulgare	búlgaro
engager	contratar
ordonnance	prescrição
morbihan	morbihan
soul	soul
avancée	avançado
avancée	avançada
alpha	alpha
alpha	alfa
abus	abuso
tube	tubo
miroir	espelho
acheter	comprar
actuelles	atuais
lumières	luzes
alberta	alberta
observer	observar
observer	observando
rick	rick
primaires	primário
descendant	descendente
magie	magia
fromage	queijo
exécuté	executado
indiana	indiana
estimé	estimado
conjoint	cônjuge
turque	turco
turque	turca
chaire	cátedra
trinité	trindade
traduire	traduzir
identifier	identificar
éditeurs	editores
nov	nov
protocole	protocolo
tirage	tiragem
éthiopie	etiópia
galaxie	galáxia
construites	construídas
blessures	lesões
blessures	feridas
jacqueline	jacqueline
batteur	baterista
roues	rodas
stefan	stefan
allan	allan
harold	harold
vidéos	vídeos
pauvre	coitado
pauvre	pobre
confirmé	confirmado
enseignants	professores
émis	emitidos
émis	emitido
copenhague	copenhaga
rayonnement	radiação
ordinaire	vulgar
ordinaire	ordinária
marines	fuzileiros
gênes	génova
sky	sky
originales	originais
sergent	sargento
yyy	yyy
retard	atraso
maxime	maxim
cleveland	cleveland
suédoise	sueco
rebelles	rebeldes
biologique	biológico
inventeur	inventor
bank	bank
chars	tanques
sea	sea
hérault	hérault
couches	camadas
renforcer	reforçar
renforcer	fortalecer
manches	mangas
profonde	profundo
brabant	brabante
bach	bach
coin	canto
conventions	convenções
rénovation	renovação
débutant	iniciante
identification	identificação
trouble	transtorno
typique	típico
kate	kate
collines	colinas
élaboration	elaboração
molière	molière
arcade	arcada
arcade	arcade
delta	delta
rafael	rafael
collective	coletivo
pakistan	paquistão
yvelines	yvelines
bloquer	bloquear
socialistes	socialistas
kosovo	kosovo
nordique	nórdico
preuves	provas
afghanistan	afeganistão
ncaa	ncaa
people	people
helen	helen
arrêts	acórdãos
arrêts	paragens
aimé	amei
aimé	amado
projection	projeção
arbitres	árbitros
popularité	popularidade
han	han
organisées	organizadas
synagogue	sinagoga
simpson	simpson
calvados	calvados
campbell	campbell
verdun	verdun
courbe	curva
pan	pan
domine	domina
mercure	mercúrio
installés	instalados
installés	instalado
plomb	chumbo
synonyme	sinônimo
gymnastique	ginástica
envie	inveja
naturellement	naturalmente
light	light
troyes	troyes
polo	polo
prononcé	pronunciado
constellation	constelação
annales	anais
diane	diane
déplacer	mover
mitchell	mitchell
ngc	ngc
gagnant	vencedor
armoiries	brasão
qualifications	qualificações
emploie	emprega
apparu	apareceu
commandes	encomendas
mickey	mickey
légendes	lendas
adaptée	adaptada
africains	africanos
essaie	tenta
essaie	experimenta
mercedes	mercedes
bâton	pau
raphaël	rafael
kiev	kiev
sac	saco
flûte	flauta
arabie	arábia
plaques	placas
dispositions	disposições
cratère	cratera
johannes	johannes
annexe	anexo
hard	hard
ralph	ralph
leo	leo
games	games
traction	tração
désolé	desculpa
désolé	desculpe
géologie	geologia
parlé	falou
parlé	falado
cnrs	cnrs
army	army
harvard	harvard
bowl	bowl
chasseur	caçador
légers	ligeiros
vend	vende
java	java
sénateurs	senadores
signer	assinar
trou	buraco
courrier	correio
permanent	permanente
put	put
lorient	lorient
matériau	material
neil	neil
ron	ron
sondage	enquete
moon	moon
légale	legal
inspire	inspira
inspire	inspire
diriger	liderar
lutter	lutar
constitutionnel	constitucional
pure	pura
pure	puro
rapides	velozes
rapides	rápidos
organisés	organizados
pourcentage	porcentagem
pourcentage	percentagem
exprimés	expressos
carrefour	carrefour
traditionnels	tradicionais
evans	evans
alexandrie	alexandria
prête	pronta
patients	doentes
susan	susan
garcía	garcía
dublin	dublin
harvey	harvey
justin	justin
dunkerque	dunquerque
couramment	comumente
patient	paciente
approximativement	aproximadamente
missouri	missouri
référendum	referendo
roses	rosas
pèlerinage	peregrinação
robot	robô
sony	sony
turcs	turcos
calcaire	calcário
fame	fame
stockage	armazenamento
réservé	reservado
interprétée	interpretada
traductions	traduções
url	url
tellement	tão
atlantiques	atlânticas
wright	wright
jon	jon
brut	bruto
pur	puro
triangle	triângulo
pittsburgh	pittsburgh
possédant	possuindo
défend	defende
adopte	adota
propagande	propaganda
convaincre	convencer
témoins	testemunhas
sánchez	sánchez
thaïlande	tailândia
militants	ativistas
contacter	contactar
contacter	contato
contacter	contatar
flamand	flamengo
hier	ontem
recettes	receitas
quatuor	quarteto
supprimée	suprimida
créées	criadas
mexicain	mexicano
agnès	inês
oublier	esquecer
conversion	conversão
folie	loucura
caire	cairo
orne	orne
network	network
dauphin	golfinho
titré	titulado
martina	martina
évoluer	evoluir
femelles	fêmeas
prototype	protótipo
dom	dom
magasins	lojas
athlètes	atletas
comédien	ator
comédien	comediante
traditionnelles	tradicional
traditionnelles	tradicionais
botaniste	botânica
botaniste	botânico
attribue	atribui
assuré	segurado
impulsion	impulso
stuttgart	estugarda
luke	luke
températures	temperaturas
dépression	depressão
dean	dean
liverpool	liverpool
générations	gerações
